chr_name,start,end,transcript_size,CDS_length,number_exons,transcript_id,gene_id,targets
2L,7680,8607,927,850,2,FBtr0300689,FBgn0031208,11
2L,11218,19944,8726,3451,8,FBtr0078166,FBgn0002121,21
2L,11313,17136,5823,3272,7,FBtr0330655,FBgn0002121,21
2L,21922,25151,3229,2521,5,FBtr0113008,FBgn0031209,24
2L,26524,58150,31626,3105,12,FBtr0078163,FBgn0051973,34
2L,67625,70892,3267,3017,4,FBtr0078100,FBgn0067779,21
2L,72013,76095,4082,1200,3,FBtr0306540,FBgn0031213,7
2L,76446,77706,1260,1201,2,FBtr0306541,FBgn0031214,2
2L,83271,87092,3821,1078,2,FBtr0290323,FBgn0002931,18
2L,94852,101915,7063,6180,12,FBtr0078103,FBgn0031216,38
2L,102459,103760,1301,1119,3,FBtr0078104,FBgn0031217,10
2L,104476,106642,2166,1942,5,FBtr0301452,FBgn0026787,10
2L,108686,112738,4052,594,6,FBtr0089428,FBgn0005278,1
2L,109751,113539,3788,1137,6,FBtr0089436,FBgn0005278,3
2L,115716,116117,401,401,1,FBtr0078160,FBgn0031219,7
2L,117334,120032,2698,2022,9,FBtr0078156,FBgn0031220,14
2L,123132,130551,7419,2089,8,FBtr0078153,FBgn0025683,20
2L,132483,133679,1196,1196,1,FBtr0078114,FBgn0001142,11
2L,138698,139336,638,580,2,FBtr0302194,FBgn0051976,2
2L,139474,140933,1459,1245,3,FBtr0302195,FBgn0051975,24
2L,141133,142487,1354,1236,3,FBtr0300987,FBgn0051974,14
2L,143378,144091,713,713,1,FBtr0078116,FBgn0031224,17
2L,144377,153106,8729,4956,9,FBtr0301929,FBgn0259818,56
2L,153680,155247,1567,1498,2,FBtr0078147,FBgn0031227,8
2L,155572,155947,375,301,2,FBtr0078117,FBgn0031228,2
2L,156241,157538,1297,1038,3,FBtr0078119,FBgn0031229,12
2L,157947,158603,656,595,2,FBtr0091612,FBgn0053635,4
2L,162823,201411,38588,16589,10,FBtr0078121,FBgn0016977,142
2L,203870,204714,844,742,2,FBtr0078124,FBgn0031231,6
2L,205047,206044,997,879,3,FBtr0078146,FBgn0031232,8
2L,207512,209855,2343,2142,3,FBtr0078125,FBgn0031233,22
2L,212188,242287,30099,15949,17,FBtr0078144,FBgn0266557,187
2L,232572,233962,1390,1327,2,FBtr0078126,FBgn0031235,4
2L,251197,252317,1120,886,5,FBtr0078143,FBgn0283652,5
2L,252666,254379,1713,1511,4,FBtr0078140,FBgn0031238,16
2L,263785,266688,2903,2903,1,FBtr0078142,FBgn0031239,48
2L,269192,271311,2119,1995,3,FBtr0078127,FBgn0031240,9
2L,271970,273634,1664,1615,2,FBtr0078139,FBgn0086912,34
2L,273986,274648,662,662,1,FBtr0078128,FBgn0086856,2
2L,274950,277142,2192,1826,4,FBtr0300804,FBgn0086855,24
2L,277826,281511,3685,3102,6,FBtr0078129,FBgn0003444,19
2L,282175,283147,972,823,2,FBtr0078137,FBgn0031244,11
2L,283889,286498,2609,732,3,FBtr0078135,FBgn0031245,7
2L,287405,288919,1514,1514,1,FBtr0078134,FBgn0025686,19
2L,292569,292999,430,373,2,FBtr0078130,FBgn0031247,7
2L,293625,294484,859,790,2,FBtr0078133,FBgn0017457,18
2L,295272,297046,1774,1466,4,FBtr0078131,FBgn0024352,13
2L,299062,302656,3594,1486,2,FBtr0331205,FBgn0020622,13
2L,318028,345445,27417,3920,16,FBtr0078047,FBgn0004611,38
2L,318421,319233,812,812,1,FBtr0078099,FBgn0031248,10
2L,320391,321221,830,830,1,FBtr0078098,FBgn0031249,10
2L,322131,322982,851,851,1,FBtr0078052,FBgn0053127,10
2L,325874,329625,3751,1219,2,FBtr0330695,FBgn0264086,12
2L,327577,329622,2045,2045,1,FBtr0330696,FBgn0264086,38
2L,329994,332132,2138,2138,1,FBtr0078096,FBgn0051921,33
2L,355921,357686,1765,1424,4,FBtr0078094,FBgn0031250,13
2L,384551,387267,2716,1220,4,FBtr0078053,FBgn0000061,32
2L,396737,401663,4926,3754,5,FBtr0078093,FBgn0031251,72
2L,404384,407891,3507,3384,3,FBtr0078054,FBgn0003278,17
2L,409391,413459,4068,2812,8,FBtr0089488,FBgn0264855,16
2L,415389,417631,2242,2097,3,FBtr0078055,FBgn0263933,24
2L,418560,419600,1040,1040,1,FBtr0078090,FBgn0031252,19
2L,420075,420555,480,334,2,FBtr0078056,FBgn0002593,4
2L,420944,421366,422,422,1,FBtr0078089,FBgn0031253,9
2L,421800,422432,632,577,2,FBtr0078057,FBgn0031254,9
2L,423452,425288,1836,1643,4,FBtr0078058,FBgn0031255,22
2L,438425,447246,8821,4276,5,FBtr0078059,FBgn0004583,56
2L,449024,450794,1770,1469,4,FBtr0078087,FBgn0015924,11
2L,453262,454382,1120,1060,2,FBtr0078060,FBgn0031256,22
2L,455801,458387,2586,1994,7,FBtr0078061,FBgn0031257,45
2L,460518,464933,4415,4415,1,FBtr0310034,FBgn0031258,72
2L,473113,475799,2686,2242,5,FBtr0078062,FBgn0027592,28
2L,476990,479475,2485,1282,2,FBtr0078083,FBgn0043364,14
2L,491316,539953,48637,3586,8,FBtr0310027,FBgn0003963,76
2L,541771,542247,476,476,1,FBtr0078081,FBgn0010602,12
2L,543244,544542,1298,1164,3,FBtr0078080,FBgn0031260,13
2L,545192,546950,1758,1319,4,FBtr0078064,FBgn0031261,31
2L,547417,551857,4440,1422,3,FBtr0078079,FBgn0005660,61
2L,553940,558762,4822,4503,6,FBtr0078078,FBgn0260933,64
2L,559699,560312,613,553,2,FBtr0078066,FBgn0031263,16
2L,560797,563181,2384,2384,1,FBtr0078076,FBgn0031264,92
2L,564227,566326,2099,2099,1,FBtr0078067,FBgn0031265,51
2L,566429,568064,1635,1460,4,FBtr0078075,FBgn0021874,34
2L,568406,572647,4241,4017,3,FBtr0078068,FBgn0031266,55
2L,573209,574135,926,926,1,FBtr0078074,FBgn0031267,10
2L,574641,575233,592,456,3,FBtr0078069,FBgn0031268,3
2L,575780,576522,742,573,3,FBtr0333746,FBgn0013323,9
2L,577993,579247,1254,1068,3,FBtr0078070,FBgn0023489,24
2L,584182,594206,10024,1242,3,FBtr0343220,FBgn0010323,28
2L,602871,603336,465,397,2,FBtr0078071,FBgn0031270,16
2L,620436,621182,746,746,1,FBtr0308305,FBgn0040106,22
2L,624644,625450,806,806,1,FBtr0077998,FBgn0040107,12
2L,625663,628140,2477,2477,1,FBtr0077999,FBgn0031273,53
2L,640962,707766,66804,10657,11,FBtr0078045,FBgn0284247,146
2L,728508,730451,1943,1943,1,FBtr0078000,FBgn0011244,16
2L,738077,740947,2870,1683,6,FBtr0078043,FBgn0026438,16
2L,753119,760910,7791,3905,10,FBtr0078001,FBgn0031275,71
2L,773595,773915,320,320,1,FBtr0078003,FBgn0031276,9
2L,776542,776838,296,296,1,FBtr0078004,FBgn0040725,14
2L,779204,779560,356,356,1,FBtr0078005,FBgn0031277,16
2L,781297,782821,1524,1337,4,FBtr0078006,FBgn0041250,13
2L,784421,786136,1715,1715,1,FBtr0078007,FBgn0031279,21
2L,786263,790629,4366,2299,5,FBtr0078042,FBgn0000442,34
2L,810646,811429,783,608,4,FBtr0078008,FBgn0051658,11
2L,811636,813308,1672,1606,2,FBtr0078009,FBgn0086130,20
2L,813460,815831,2371,2146,5,FBtr0078041,FBgn0031281,28
2L,816083,816973,890,890,1,FBtr0078010,FBgn0031282,8
2L,817049,817898,849,787,2,FBtr0078040,FBgn0031283,21
2L,818510,819334,824,763,2,FBtr0078039,FBgn0031284,13
2L,820079,820966,887,887,1,FBtr0078011,FBgn0015621,22
2L,821552,823773,2221,954,3,FBtr0078012,FBgn0031285,14
2L,824436,825797,1361,1361,1,FBtr0078038,FBgn0031286,25
2L,829536,831920,2384,1639,5,FBtr0078014,FBgn0010583,42
2L,834548,837338,2790,1337,4,FBtr0078037,FBgn0020304,39
2L,834947,850068,15121,1538,4,FBtr0334763,FBgn0020304,46
2L,851446,852629,1183,1010,4,FBtr0078034,FBgn0031287,19
2L,852936,854380,1444,990,3,FBtr0078016,FBgn0020545,25
2L,855550,856104,554,432,3,FBtr0078017,FBgn0031288,10
2L,860321,861693,1372,945,3,FBtr0078018,FBgn0031289,12
2L,862169,864745,2576,2329,5,FBtr0078031,FBgn0029095,63
2L,868742,869776,1034,1034,1,FBtr0078030,FBgn0020305,13
2L,871574,873715,2141,1880,4,FBtr0091486,FBgn0053526,15
2L,877362,878170,808,709,2,FBtr0078023,FBgn0002936,14
2L,878284,885052,6768,5856,15,FBtr0332181,FBgn0031292,108
2L,898732,901166,2434,2365,2,FBtr0078025,FBgn0002563,47
2L,914198,917733,3535,2809,11,FBtr0336969,FBgn0046113,40
2L,930335,957449,27114,2804,10,FBtr0077949,FBgn0028481,83
2L,1013956,1042988,29032,3946,11,FBtr0301416,FBgn0031294,154
2L,1026279,1026785,506,506,1,FBtr0077997,FBgn0031295,30
2L,1037379,1038419,1040,1040,1,FBtr0077951,FBgn0031296,25
2L,1052041,1062146,10105,1787,4,FBtr0077993,FBgn0003310,53
2L,1078035,1080707,2672,2559,3,FBtr0077952,FBgn0015905,52
2L,1081244,1082868,1624,1228,5,FBtr0077953,FBgn0031298,42
2L,1084022,1087862,3840,1703,7,FBtr0332570,FBgn0031299,42
2L,1103694,1108202,4508,4099,8,FBtr0077989,FBgn0261938,84
2L,1108701,1112640,3939,3044,7,FBtr0077954,FBgn0031301,39
2L,1112988,1113947,959,788,4,FBtr0077955,FBgn0031302,31
2L,1115737,1128345,12608,743,4,FBtr0077987,FBgn0016926,17
2L,1129489,1131950,2461,2064,3,FBtr0077956,FBgn0031304,39
2L,1132481,1134073,1592,1592,1,FBtr0077986,FBgn0031305,69
2L,1134859,1139953,5094,1330,5,FBtr0077957,FBgn0031306,81
2L,1143371,1147072,3701,1532,4,FBtr0077958,FBgn0031307,35
2L,1147865,1149373,1508,1508,1,FBtr0077959,FBgn0283525,37
2L,1149517,1150647,1130,892,5,FBtr0077985,FBgn0031309,11
2L,1150863,1151408,545,545,1,FBtr0077960,FBgn0031310,12
2L,1152035,1153504,1469,1268,4,FBtr0100022,FBgn0261458,27
2L,1158976,1160097,1121,832,2,FBtr0077961,FBgn0031312,32
2L,1160447,1163088,2641,1658,4,FBtr0077981,FBgn0031313,51
2L,1164540,1166358,1818,1759,2,FBtr0077962,FBgn0031314,47
2L,1166560,1167159,599,538,2,FBtr0077964,FBgn0031315,9
2L,1167246,1169785,2539,2357,4,FBtr0077980,FBgn0024314,45
2L,1170234,1170762,528,414,3,FBtr0077965,FBgn0051922,3
2L,1170796,1172619,1823,1568,4,FBtr0077979,FBgn0031317,28
2L,1173201,1177369,4168,3000,12,FBtr0077966,FBgn0031318,45
2L,1177950,1182283,4333,2835,12,FBtr0077968,FBgn0031319,59
2L,1182498,1183919,1421,1363,2,FBtr0077978,FBgn0031320,28
2L,1184166,1185514,1348,1279,2,FBtr0077971,FBgn0031321,30
2L,1191684,1196440,4756,1046,4,FBtr0077972,FBgn0031322,20
2L,1198602,1199138,536,536,1,FBtr0077977,FBgn0031323,20
2L,1199450,1199575,125,125,1,FBtr0307096,FBgn0263080,5
2L,1200240,1200449,209,209,1,FBtr0307097,FBgn0263081,26
2L,1200860,1201099,239,239,1,FBtr0077973,FBgn0040723,7
2L,1204316,1204972,656,419,4,FBtr0114498,FBgn0031324,9
2L,1219363,1229468,10105,2065,8,FBtr0299796,FBgn0259229,53
2L,1240068,1242142,2074,1993,2,FBtr0077920,FBgn0031327,51
2L,1256891,1293683,36792,4014,12,FBtr0077921,FBgn0041097,86
2L,1329178,1329864,686,628,2,FBtr0077922,FBgn0011294,7
2L,1334269,1334834,565,505,2,FBtr0305552,FBgn0031331,13
2L,1341368,1342095,727,530,4,FBtr0343846,FBgn0053923,21
2L,1343446,1344171,725,530,4,FBtr0091926,FBgn0053922,18
2L,1344616,1344882,266,266,1,FBtr0077924,FBgn0026141,0
2L,1351863,1352815,952,895,2,FBtr0077948,FBgn0031332,18
2L,1353042,1354005,963,913,2,FBtr0077947,FBgn0031333,12
2L,1354184,1354891,707,707,1,FBtr0077946,FBgn0051924,25
2L,1354977,1355768,791,718,2,FBtr0077944,FBgn0031335,10
2L,1358974,1359783,809,571,5,FBtr0077943,FBgn0051659,11
2L,1360087,1361657,1570,729,6,FBtr0329947,FBgn0053126,14
2L,1368242,1368961,719,615,3,FBtr0077926,FBgn0031337,10
2L,1381447,1420165,38718,4543,14,FBtr0329985,FBgn0002543,117
2L,1428668,1428844,176,176,1,FBtr0308744,FBgn0263320,7
2L,1442787,1443278,491,491,1,FBtr0308745,FBgn0263321,26
2L,1492314,1493567,1253,1253,1,FBtr0077929,FBgn0051928,30
2L,1494146,1495360,1214,1214,1,FBtr0077930,FBgn0053128,19
2L,1495747,1496976,1229,1229,1,FBtr0077931,FBgn0051926,36
2L,1497254,1498432,1178,1178,1,FBtr0077932,FBgn0051661,17
2L,1498669,1500192,1523,1200,3,FBtr0077936,FBgn0031343,45
2L,1500917,1502628,1711,1160,4,FBtr0334820,FBgn0031344,22
2L,1516863,1517438,575,575,1,FBtr0077919,FBgn0031345,12
2L,1517735,1518061,326,326,1,FBtr0114554,FBgn0001174,4
2L,1520613,1522048,1435,1187,4,FBtr0077873,FBgn0026398,48
2L,1522703,1524156,1453,1187,4,FBtr0077874,FBgn0026397,37
2L,1584993,1587032,2039,1975,2,FBtr0077917,FBgn0031347,41
2L,1595046,1611071,16025,2743,5,FBtr0077916,FBgn0051935,53
2L,1600634,1606516,5882,2935,8,FBtr0310017,FBgn0261509,70
2L,1611508,1612397,889,751,2,FBtr0077876,FBgn0031351,13
2L,1612773,1614076,1303,687,3,FBtr0077915,FBgn0021906,24
2L,1690638,1696146,5508,1807,5,FBtr0077877,FBgn0086758,47
2L,1705112,1706224,1112,826,2,FBtr0077881,FBgn0011570,9
2L,1707775,1710315,2540,1598,10,FBtr0077912,FBgn0031356,18
2L,1710526,1711282,756,540,3,FBtr0077882,FBgn0031357,8
2L,1711755,1715556,3801,2846,7,FBtr0077911,FBgn0086698,57
2L,1717106,1723928,6822,1088,7,FBtr0077910,FBgn0031359,21
2L,1725344,1727833,2489,1498,2,FBtr0077905,FBgn0000579,31
2L,1728829,1729524,695,695,1,FBtr0077883,FBgn0260648,18
2L,1729984,1730946,962,962,1,FBtr0077884,FBgn0031360,11
2L,1731406,1732263,857,729,3,FBtr0077904,FBgn0031361,9
2L,1741701,1750083,8382,2287,11,FBtr0077885,FBgn0264494,47
2L,1750874,1752025,1151,1151,1,FBtr0077903,FBgn0027597,6
2L,1752383,1752766,383,383,1,FBtr0077887,FBgn0031364,8
2L,1755256,1756451,1195,1132,2,FBtr0077902,FBgn0041249,24
2L,1758404,1759052,648,373,2,FBtr0077901,FBgn0031365,7
2L,1784062,1785283,1221,1165,2,FBtr0077888,FBgn0045497,21
2L,1789144,1790361,1217,1158,2,FBtr0310114,FBgn0045498,66
2L,1790620,1791823,1203,1147,2,FBtr0077899,FBgn0265138,32
2L,1792060,1793268,1208,1156,2,FBtr0100188,FBgn0045500,35
2L,1793671,1794917,1246,1180,2,FBtr0077897,FBgn0045501,44
2L,1821273,1823291,2018,2018,1,FBtr0077896,FBgn0051933,27
2L,1824407,1826193,1786,1580,4,FBtr0303377,FBgn0051664,54
2L,1831795,1832454,659,601,2,FBtr0077894,FBgn0031367,12
2L,1842999,1856807,13808,3460,11,FBtr0089786,FBgn0051665,82
2L,1858831,1880114,21283,2886,12,FBtr0077893,FBgn0051663,34
2L,1869912,1870826,914,914,1,FBtr0077891,FBgn0031372,29
2L,1882418,1883104,686,686,1,FBtr0347155,FBgn0031373,11
2L,1910072,1942962,32890,4507,17,FBtr0077811,FBgn0031374,53
2L,1945308,1945652,344,344,1,FBtr0077871,FBgn0040719,4
2L,1945843,1946663,820,702,3,FBtr0307516,FBgn0053673,10
2L,1950798,1954325,3527,2092,2,FBtr0330202,FBgn0031375,73
2L,1974236,1975184,948,731,4,FBtr0077813,FBgn0267972,16
2L,1976545,1980612,4067,3064,5,FBtr0077869,FBgn0031377,97
2L,1981310,1981924,614,501,3,FBtr0077814,FBgn0031378,15
2L,1982312,1984390,2078,1907,4,FBtr0077815,FBgn0031379,27
2L,1984709,1987652,2943,1267,5,FBtr0077867,FBgn0001125,18
2L,1988389,1988832,443,443,1,FBtr0077816,FBgn0031381,11
2L,1991749,1992152,403,349,2,FBtr0100503,FBgn0043539,13
2L,1997777,2005615,7838,1397,7,FBtr0309285,FBgn0053543,38
2L,2006907,2007146,239,157,2,FBtr0077863,FBgn0040718,4
2L,2008530,2008852,322,190,2,FBtr0077817,FBgn0040717,9
2L,2010118,2029935,19817,2895,9,FBtr0301068,FBgn0031384,46
2L,2032638,2035936,3298,2980,2,FBtr0299676,FBgn0259192,21
2L,2036459,2037247,788,788,1,FBtr0299675,FBgn0259230,19
2L,2039992,2043180,3188,2841,6,FBtr0077822,FBgn0003557,49
2L,2045610,2047574,1964,1637,4,FBtr0077825,FBgn0028952,39
2L,2054589,2057964,3375,1200,6,FBtr0077826,FBgn0026396,17
2L,2059856,2094797,34941,1559,7,FBtr0300671,FBgn0053516,61
2L,2080077,2081167,1090,939,3,FBtr0077827,FBgn0031388,17
2L,2128336,2129207,871,808,2,FBtr0077854,FBgn0031389,19
2L,2131012,2136883,5871,2528,4,FBtr0077828,FBgn0004507,47
2L,2137672,2145031,7359,4908,15,FBtr0077853,FBgn0031390,51
2L,2145903,2147024,1121,1048,2,FBtr0077852,FBgn0031391,18
2L,2147647,2151450,3803,3562,5,FBtr0077829,FBgn0027509,53
2L,2152035,2154894,2859,2015,7,FBtr0077830,FBgn0031392,24
2L,2155783,2156253,470,470,1,FBtr0077832,FBgn0031393,10
2L,2158168,2160491,2323,2193,3,FBtr0077850,FBgn0000097,42
2L,2190426,2192263,1837,944,4,FBtr0077848,FBgn0031395,36
2L,2192575,2192822,247,184,2,FBtr0112363,FBgn0085201,0
2L,2203776,2206028,2252,1761,9,FBtr0307523,FBgn0051668,47
2L,2206659,2208906,2247,1755,9,FBtr0307522,FBgn0053124,63
2L,2210252,2212375,2123,1756,5,FBtr0077845,FBgn0031397,21
2L,2212973,2213931,958,677,4,FBtr0077844,FBgn0010288,23
2L,2214312,2215144,832,648,3,FBtr0112365,FBgn0085203,14
2L,2215334,2216225,891,835,2,FBtr0077843,FBgn0031398,17
2L,2216578,2216808,230,230,1,FBtr0077842,FBgn0040715,6
2L,2216829,2217142,313,259,2,FBtr0299970,FBgn0259717,2
2L,2217427,2220407,2980,2594,7,FBtr0077835,FBgn0031399,29
2L,2223329,2225237,1908,1724,4,FBtr0077836,FBgn0031401,25
2L,2225801,2226205,404,346,2,FBtr0113015,FBgn0031403,0
2L,2227069,2230123,3054,877,5,FBtr0077840,FBgn0267378,11
2L,2231937,2236541,4604,3686,7,FBtr0329965,FBgn0262126,57
2L,2237135,2238207,1072,1009,2,FBtr0077809,FBgn0051679,9
2L,2238349,2239365,1016,952,2,FBtr0077808,FBgn0052463,19
2L,2239474,2240502,1028,955,2,FBtr0077807,FBgn0051682,15
2L,2242522,2244358,1836,1119,3,FBtr0077751,FBgn0264979,19
2L,2250536,2251270,734,734,1,FBtr0077806,FBgn0011832,24
2L,2251587,2252330,743,743,1,FBtr0077805,FBgn0042186,18
2L,2253079,2253831,752,752,1,FBtr0077753,FBgn0042187,6
2L,2254276,2255040,764,764,1,FBtr0077804,FBgn0031406,18
2L,2263558,2264181,623,507,3,FBtr0077754,FBgn0031407,0
2L,2264270,2265311,1041,915,3,FBtr0302372,FBgn0054049,42
2L,2268359,2269093,734,734,1,FBtr0077803,FBgn0250841,17
2L,2285174,2285899,725,725,1,FBtr0077756,FBgn0031409,10
2L,2286053,2286844,791,791,1,FBtr0077802,FBgn0051681,28
2L,2287382,2287918,536,390,3,FBtr0302458,FBgn0261523,10
2L,2288632,2289207,575,575,1,FBtr0077801,FBgn0031410,12
2L,2290332,2290622,290,290,1,FBtr0077800,FBgn0028570,5
2L,2300181,2300714,533,533,1,FBtr0077757,FBgn0051949,12
2L,2308027,2308668,641,434,4,FBtr0077758,FBgn0031412,15
2L,2308886,2310427,1541,891,3,FBtr0077799,FBgn0031413,31
2L,2323766,2357874,34108,6515,13,FBtr0344662,FBgn0031414,159
2L,2360472,2361428,956,653,4,FBtr0077793,FBgn0014010,13
2L,2366321,2368978,2657,2554,2,FBtr0077762,FBgn0261647,60
2L,2370272,2371426,1154,1002,3,FBtr0077792,FBgn0031417,16
2L,2372513,2373701,1188,1001,4,FBtr0077791,FBgn0031418,15
2L,2374756,2375636,880,823,2,FBtr0077764,FBgn0031419,8
2L,2377202,2380174,2972,2911,2,FBtr0077765,FBgn0031420,70
2L,2381334,2383001,1667,1557,3,FBtr0077767,FBgn0264672,25
2L,2383299,2384728,1429,1375,2,FBtr0077768,FBgn0031422,30
2L,2384835,2385702,867,811,2,FBtr0077790,FBgn0031423,18
2L,2389859,2390635,776,776,1,FBtr0330686,FBgn0264081,65
2L,2402245,2407695,5450,1889,7,FBtr0077769,FBgn0031424,32
2L,2410887,2414902,4015,1103,4,FBtr0307079,FBgn0031426,15
2L,2415506,2416621,1115,1115,1,FBtr0077787,FBgn0051948,12
2L,2416812,2417965,1153,1029,3,FBtr0112752,FBgn0085477,16
2L,2418478,2419764,1286,1164,3,FBtr0112751,FBgn0085476,14
2L,2420896,2422412,1516,1459,2,FBtr0077770,FBgn0031428,35
2L,2424841,2425008,167,167,1,FBtr0335463,FBgn0264988,6
2L,2455071,2458557,3486,1762,2,FBtr0077771,FBgn0000490,41
2L,2490349,2492520,2171,1912,5,FBtr0077782,FBgn0264978,9
2L,2493030,2496694,3664,992,4,FBtr0077777,FBgn0011818,24
2L,2517199,2517956,757,703,2,FBtr0077781,FBgn0031430,17
2L,2551400,2552754,1354,1183,2,FBtr0077750,FBgn0031431,23
2L,2562908,2564776,1868,1512,6,FBtr0335166,FBgn0031432,53
2L,2565088,2573009,7921,1608,6,FBtr0077748,FBgn0041337,43
2L,2573486,2574380,894,820,2,FBtr0077747,FBgn0026778,16
2L,2574385,2574981,596,535,2,FBtr0112512,FBgn0085343,6
2L,2575454,2576645,1191,1126,2,FBtr0077746,FBgn0031434,15
2L,2577863,2579005,1142,1142,1,FBtr0077693,FBgn0031435,31
2L,2579359,2579954,595,422,4,FBtr0077745,FBgn0031436,2
2L,2580369,2580883,514,451,2,FBtr0077694,FBgn0031437,3
2L,2581785,2585271,3486,2197,8,FBtr0077744,FBgn0026479,56
2L,2592160,2592695,535,475,2,FBtr0335171,FBgn0250835,12
2L,2610167,2611047,880,823,2,FBtr0114513,FBgn0031440,20
2L,2620433,2620558,125,125,1,FBtr0308746,FBgn0263322,3
2L,2646689,2647645,956,956,1,FBtr0077743,FBgn0031441,8
2L,2647924,2648358,434,434,1,FBtr0332512,FBgn0264433,27
2L,2648443,2652291,3848,3787,2,FBtr0302456,FBgn0053125,146
2L,2653147,2653842,695,643,2,FBtr0077697,FBgn0031442,11
2L,2654143,2655330,1187,1135,2,FBtr0077698,FBgn0026395,15
2L,2655460,2656151,691,628,2,FBtr0077699,FBgn0031443,7
2L,2665143,2666192,1049,991,2,FBtr0077700,FBgn0031444,13
2L,2669823,2672156,2333,1107,3,FBtr0273435,FBgn0041248,21
2L,2684123,2719339,35216,2570,7,FBtr0301682,FBgn0051690,111
2L,2695379,2696407,1028,912,3,FBtr0300986,FBgn0031446,27
2L,2725730,2739497,13767,1861,11,FBtr0334161,FBgn0031449,28
2L,2740181,2743082,2901,2275,5,FBtr0089750,FBgn0031450,65
2L,2743461,2744924,1463,1341,3,FBtr0077740,FBgn0031451,45
2L,2745199,2746878,1679,1560,3,FBtr0077712,FBgn0031452,35
2L,2747015,2748381,1366,1242,3,FBtr0077739,FBgn0250906,39
2L,2753415,2756291,2876,453,3,FBtr0077713,FBgn0031453,22
2L,2758553,2759224,671,671,1,FBtr0100383,FBgn0031454,13
2L,2759246,2759647,401,401,1,FBtr0077737,FBgn0031455,10
2L,2760033,2763208,3175,2791,5,FBtr0077715,FBgn0031456,51
2L,2764309,2765502,1193,974,4,FBtr0077736,FBgn0031457,29
2L,2766315,2767087,772,712,2,FBtr0077716,FBgn0031458,11
2L,2767340,2767777,437,437,1,FBtr0077735,FBgn0026324,9
2L,2767981,2768540,559,499,2,FBtr0077717,FBgn0028398,1
2L,2768648,2769565,917,917,1,FBtr0077731,FBgn0019830,20
2L,2770151,2770726,575,447,3,FBtr0077718,FBgn0031459,11
2L,2770941,2771735,794,724,2,FBtr0077730,FBgn0031460,16
2L,2783071,2793888,10817,1414,8,FBtr0077726,FBgn0004242,24
2L,2809311,2811756,2445,1754,4,FBtr0077720,FBgn0031461,39
2L,2812538,2814262,1724,1660,2,FBtr0077722,FBgn0031462,38
2L,2814409,2815689,1280,1045,5,FBtr0113017,FBgn0031463,5
2L,2816345,2827768,11423,4602,9,FBtr0300382,FBgn0283531,61
2L,2823603,2825504,1901,1901,1,FBtr0077723,FBgn0031465,31
2L,2834970,2837788,2818,1061,4,FBtr0077691,FBgn0031466,44
2L,2838474,2839450,976,904,2,FBtr0077618,FBgn0031467,40
2L,2840997,2842435,1438,1151,4,FBtr0077619,FBgn0031468,47
2L,2842638,2844513,1875,1761,3,FBtr0273251,FBgn0031469,53
2L,2844622,2845711,1089,1027,2,FBtr0077689,FBgn0031470,49
2L,2846087,2847197,1110,1039,2,FBtr0300356,FBgn0031471,25
2L,2847641,2848731,1090,1030,2,FBtr0335130,FBgn0031472,33
2L,2849735,2853262,3527,959,4,FBtr0077686,FBgn0031473,24
2L,2856256,2856637,381,246,3,FBtr0077621,FBgn0015521,3
2L,2864984,2867664,2680,1681,5,FBtr0077625,FBgn0031474,29
2L,2869174,2873672,4498,1270,5,FBtr0077685,FBgn0051694,26
2L,2869746,2870597,851,851,1,FBtr0077628,FBgn0031476,12
2L,2875388,2876359,971,971,1,FBtr0077629,FBgn0031478,18
2L,2877191,2878137,946,663,3,FBtr0077684,FBgn0031479,12
2L,2878593,2878955,362,362,1,FBtr0077630,FBgn0051950,20
2L,2879264,2880468,1204,1039,2,FBtr0077631,FBgn0028970,41
2L,2881231,2882104,873,811,2,FBtr0077680,FBgn0024947,17
2L,2890882,2952222,61340,4868,10,FBtr0452101,FBgn0041111,147
2L,2961231,2963383,2152,1326,6,FBtr0077637,FBgn0010263,37
2L,2968608,2969570,962,962,1,FBtr0077679,FBgn0024920,24
2L,2969995,2972297,2302,2032,5,FBtr0077678,FBgn0004584,42
2L,2973059,2974601,1542,1422,3,FBtr0077641,FBgn0260639,13
2L,2975181,2976785,1604,1604,1,FBtr0077676,FBgn0031483,27
2L,2977242,2978350,1108,1051,2,FBtr0077642,FBgn0031484,18
2L,2978549,2979205,656,656,1,FBtr0077675,FBgn0031485,19
2L,2980179,2987520,7341,5642,7,FBtr0077674,FBgn0250786,96
2L,2988245,2989508,1263,1009,5,FBtr0077643,FBgn0025109,19
2L,2990070,2992709,2639,2346,6,FBtr0077673,FBgn0002989,44
2L,2993735,2998245,4510,3117,6,FBtr0077644,FBgn0025681,80
2L,3013502,3015459,1957,1818,3,FBtr0077646,FBgn0031488,74
2L,3016779,3017969,1190,894,6,FBtr0077671,FBgn0031489,13
2L,3018950,3021224,2274,2109,3,FBtr0077647,FBgn0031490,55
2L,3021789,3022949,1160,1105,2,FBtr0077670,FBgn0031491,38
2L,3023388,3026113,2725,2412,6,FBtr0077648,FBgn0031492,34
2L,3026608,3029087,2479,2242,5,FBtr0077669,FBgn0031493,30
2L,3029420,3030392,972,919,2,FBtr0077650,FBgn0031494,19
2L,3030760,3032131,1371,1257,3,FBtr0077651,FBgn0031495,16
2L,3032339,3035242,2903,2622,6,FBtr0300814,FBgn0031496,38
2L,3035648,3037150,1502,1502,1,FBtr0077667,FBgn0031497,40
2L,3037594,3038685,1091,1091,1,FBtr0077653,FBgn0031498,17
2L,3039134,3039720,586,468,3,FBtr0077666,FBgn0243513,2
2L,3040228,3041572,1344,1236,3,FBtr0077655,FBgn0031500,36
2L,3043037,3043527,490,412,2,FBtr0077656,FBgn0031501,6
2L,3045712,3055484,9772,7221,6,FBtr0077657,FBgn0042627,155
2L,3057108,3067499,10391,7614,6,FBtr0335387,FBgn0283427,112
2L,3069573,3099579,30006,2971,8,FBtr0329907,FBgn0015600,71
2L,3069717,3144347,74630,6475,11,FBtr0077662,FBgn0015600,187
2L,3109720,3110727,1007,1007,1,FBtr0077660,FBgn0005779,16
2L,3128765,3129364,599,599,1,FBtr0077661,FBgn0031504,24
2L,3145203,3145684,481,345,3,FBtr0077617,FBgn0031505,4
2L,3147422,3149073,1651,1362,3,FBtr0077616,FBgn0011648,15
2L,3160073,3162041,1968,1735,5,FBtr0077574,FBgn0260817,51
2L,3163920,3168198,4278,1189,5,FBtr0077576,FBgn0014906,24
2L,3169917,3170951,1034,1034,1,FBtr0334134,FBgn0264744,24
2L,3173306,3173825,519,451,2,FBtr0077612,FBgn0051698,12
2L,3173992,3174422,430,364,2,FBtr0077578,FBgn0031512,1
2L,3175331,3192886,17555,2061,12,FBtr0112637,FBgn0085422,42
2L,3269817,3271608,1791,1610,4,FBtr0301033,FBgn0031513,68
2L,3275958,3280363,4405,1882,5,FBtr0077608,FBgn0031514,24
2L,3291336,3293552,2216,1821,6,FBtr0077605,FBgn0031515,39
2L,3295341,3301615,6274,2417,7,FBtr0077604,FBgn0031516,31
2L,3309427,3311648,2221,1402,5,FBtr0077580,FBgn0031517,23
2L,3313347,3317083,3736,2353,14,FBtr0114460,FBgn0031518,38
2L,3317568,3319806,2238,1562,7,FBtr0077603,FBgn0031519,31
2L,3320590,3323034,2444,1449,6,FBtr0077583,FBgn0031520,28
2L,3324367,3326574,2207,1395,6,FBtr0077584,FBgn0053281,23
2L,3327936,3329622,1686,1374,6,FBtr0113458,FBgn0053282,22
2L,3330963,3332678,1715,1392,6,FBtr0077586,FBgn0031522,19
2L,3332911,3334720,1809,1392,6,FBtr0077587,FBgn0031523,14
2L,3335660,3353392,17732,3043,8,FBtr0089979,FBgn0020445,63
2L,3357750,3358418,668,668,1,FBtr0077588,FBgn0031526,14
2L,3360721,3373047,12326,3626,10,FBtr0112638,FBgn0085423,94
2L,3373683,3375408,1725,1435,5,FBtr0113018,FBgn0031528,23
2L,3376113,3376619,506,445,2,FBtr0077594,FBgn0031529,7
2L,3377099,3378488,1389,1190,4,FBtr0077589,FBgn0016698,34
2L,3387407,3387708,301,232,2,FBtr0300295,FBgn0259949,12
2L,3388100,3388398,298,235,2,FBtr0300294,FBgn0259950,9
2L,3398135,3398392,257,257,1,FBtr0112366,FBgn0085204,6
2L,3405580,3421574,15994,1892,7,FBtr0077592,FBgn0031530,58
2L,3410690,3411103,413,413,1,FBtr0077590,FBgn0031531,12
2L,3416865,3417407,542,542,1,FBtr0077591,FBgn0051952,28
2L,3446038,3447545,1507,1245,3,FBtr0077516,FBgn0031533,24
2L,3449795,3451564,1769,1369,5,FBtr0077517,FBgn0031534,22
2L,3452617,3453593,976,756,3,FBtr0113019,FBgn0031535,31
2L,3453926,3457035,3109,2707,8,FBtr0077573,FBgn0031536,53
2L,3457406,3460268,2862,2678,4,FBtr0077519,FBgn0266670,44
2L,3460397,3461851,1454,1332,3,FBtr0077572,FBgn0031538,28
2L,3463269,3465639,2370,2317,2,FBtr0077570,FBgn0005616,88
2L,3466335,3467251,916,474,3,FBtr0077520,FBgn0021967,10
2L,3467854,3469894,2040,1987,2,FBtr0077569,FBgn0031540,31
2L,3470214,3472322,2108,1886,4,FBtr0077522,FBgn0051776,83
2L,3472803,3474927,2124,1928,4,FBtr0114524,FBgn0051956,18
2L,3478616,3479390,774,349,2,FBtr0077524,FBgn0261560,1
2L,3480957,3481916,959,959,1,FBtr0077568,FBgn0031542,21
2L,3494522,3504457,9935,4180,14,FBtr0077567,FBgn0014396,59
2L,3509175,3510072,897,829,2,FBtr0077563,FBgn0051954,14
2L,3510592,3514532,3940,3540,6,FBtr0077562,FBgn0284253,37
2L,3514984,3516972,1988,1424,4,FBtr0077525,FBgn0031544,23
2L,3517436,3519463,2027,2027,1,FBtr0077561,FBgn0031545,25
2L,3519712,3522369,2657,2166,3,FBtr0333251,FBgn0031546,32
2L,3522597,3523960,1363,1215,3,FBtr0077560,FBgn0031547,66
2L,3525209,3527197,1988,1988,1,FBtr0089937,FBgn0031548,36
2L,3527556,3530286,2730,2337,6,FBtr0301590,FBgn0031549,53
2L,3530903,3532523,1620,1212,3,FBtr0077529,FBgn0031550,14
2L,3545587,3546752,1165,241,2,FBtr0077530,FBgn0024244,2
2L,3576264,3576425,161,161,1,FBtr0332222,FBgn0264363,5
2L,3578300,3580179,1879,1732,2,FBtr0077558,FBgn0004892,60
2L,3604997,3606358,1361,1174,2,FBtr0077557,FBgn0002985,36
2L,3619286,3621070,1784,1608,3,FBtr0077532,FBgn0015663,50
2L,3621152,3621506,354,289,2,FBtr0077556,FBgn0031554,4
2L,3622781,3640455,17674,3256,8,FBtr0089304,FBgn0000721,49
2L,3668116,3668531,415,361,2,FBtr0300296,FBgn0259951,9
2L,3668728,3669120,392,331,2,FBtr0302203,FBgn0259953,4
2L,3669321,3669709,388,328,2,FBtr0300297,FBgn0259952,4
2L,3670163,3670527,364,298,2,FBtr0301934,FBgn0261054,13
2L,3673205,3691475,18270,1754,7,FBtr0302391,FBgn0085369,88
2L,3692189,3692540,351,235,2,FBtr0077550,FBgn0031558,12
2L,3692844,3693168,324,262,2,FBtr0077549,FBgn0031559,3
2L,3693558,3693860,302,232,2,FBtr0110767,FBgn0051779,3
2L,3694466,3694808,342,283,2,FBtr0305706,FBgn0262721,10
2L,3695056,3695356,300,244,2,FBtr0077547,FBgn0031560,4
2L,3696293,3696598,305,244,2,FBtr0077546,FBgn0031561,4
2L,3697376,3697771,395,395,1,FBtr0077545,FBgn0031562,14
2L,3698589,3699040,451,385,2,FBtr0077544,FBgn0031563,11
2L,3699493,3699816,323,259,2,FBtr0300300,FBgn0259954,9
2L,3700245,3700526,281,217,2,FBtr0300301,FBgn0259955,2
2L,3700700,3700995,295,238,2,FBtr0300302,FBgn0259956,10
2L,3701307,3701601,294,244,2,FBtr0300303,FBgn0259957,5
2L,3701848,3702128,280,217,2,FBtr0305483,FBgn0262621,3
2L,3703731,3704035,304,250,2,FBtr0300299,FBgn0031564,5
2L,3704422,3704973,551,304,2,FBtr0077543,FBgn0051778,4
2L,3706583,3707039,456,325,2,FBtr0077542,FBgn0051777,7
2L,3707357,3711618,4261,2967,12,FBtr0077541,FBgn0015376,43
2L,3712272,3712782,510,457,2,FBtr0077540,FBgn0051955,23
2L,3714093,3716505,2412,2117,4,FBtr0077537,FBgn0031566,15
2L,3716883,3717728,845,845,1,FBtr0077539,FBgn0040104,33
2L,3721336,3727016,5680,1850,7,FBtr0289989,FBgn0003386,26
2L,3721381,3725675,4294,1487,7,FBtr0089274,FBgn0003386,11
2L,3745692,3752187,6495,3300,12,FBtr0273188,FBgn0031568,92
2L,3757898,3768188,10290,6042,21,FBtr0321306,FBgn0263846,134
2L,3765519,3765822,303,250,2,FBtr0321298,FBgn0263842,4
2L,3779726,3783281,3555,2230,2,FBtr0077490,FBgn0004893,45
2L,3785030,3785473,443,443,1,FBtr0077494,FBgn0051960,3
2L,3790663,3802242,11579,9334,11,FBtr0077496,FBgn0031571,103
2L,3806750,3808238,1488,1199,4,FBtr0077498,FBgn0021800,20
2L,3810997,3813330,2333,2138,4,FBtr0077515,FBgn0031573,39
2L,3825784,3826749,965,965,1,FBtr0077499,FBgn0003430,25
2L,3837198,3838550,1352,1352,1,FBtr0077500,FBgn0004567,41
2L,3863581,3867221,3640,2960,7,FBtr0077501,FBgn0031574,43
2L,3867982,3871186,3204,2410,8,FBtr0077504,FBgn0031575,31
2L,3871556,3872335,779,475,2,FBtr0077514,FBgn0051957,9
2L,3872833,3893589,20756,3613,8,FBtr0077511,FBgn0000256,112
2L,3905562,3989420,83858,3961,8,FBtr0308125,FBgn0051774,38
2L,3911907,3914180,2273,2273,1,FBtr0077509,FBgn0051773,28
2L,4000042,4000737,695,695,1,FBtr0332007,FBgn0264341,19
2L,4004131,4004379,248,248,1,FBtr0112367,FBgn0085205,17
2L,4005056,4005367,311,311,1,FBtr0077505,FBgn0031579,17
2L,4006113,4006433,320,320,1,FBtr0077506,FBgn0031580,9
2L,4007703,4007927,224,224,1,FBtr0331498,FBgn0264295,9
2L,4008712,4008996,284,284,1,FBtr0331499,FBgn0264296,11
2L,4032676,4113799,81123,3988,8,FBtr0077465,FBgn0000547,59
2L,4120363,4121439,1076,957,3,FBtr0077466,FBgn0020376,36
2L,4121760,4123896,2136,1883,4,FBtr0077467,FBgn0014033,46
2L,4149349,4151043,1694,1694,1,FBtr0077468,FBgn0031585,102
2L,4164692,4166134,1442,1189,5,FBtr0289965,FBgn0026394,24
2L,4186419,4187483,1064,1064,1,FBtr0077484,FBgn0051961,9
2L,4188148,4189224,1076,1076,1,FBtr0077469,FBgn0040102,29
2L,4189945,4196565,6620,1990,11,FBtr0077479,FBgn0031589,39
2L,4199135,4217840,18705,15433,8,FBtr0077478,FBgn0001075,256
2L,4224887,4226888,2001,1921,2,FBtr0077477,FBgn0031590,18
2L,4228025,4228408,383,383,1,FBtr0077470,FBgn0003941,2
2L,4257650,4258323,673,613,2,FBtr0077471,FBgn0265269,10
2L,4278042,4279290,1248,1062,3,FBtr0077476,FBgn0031592,26
2L,4295225,4305435,10210,1126,5,FBtr0089268,FBgn0010473,12
2L,4324908,4331611,6703,2151,6,FBtr0077425,FBgn0028482,53
2L,4336674,4344477,7803,2490,6,FBtr0077426,FBgn0020762,36
2L,4353049,4353810,761,642,3,FBtr0077428,FBgn0031596,8
2L,4362549,4380096,17547,1428,3,FBtr0334401,FBgn0026319,17
2L,4380786,4382639,1853,1853,1,FBtr0077463,FBgn0031597,41
2L,4383140,4385978,2838,2657,4,FBtr0077462,FBgn0031598,26
2L,4386342,4387008,666,607,2,FBtr0331449,FBgn0261976,4
2L,4388725,4392683,3958,2422,5,FBtr0077431,FBgn0027560,20
2L,4392879,4393790,911,667,5,FBtr0077460,FBgn0031600,8
2L,4394338,4399730,5392,4338,9,FBtr0077432,FBgn0022153,58
2L,4401120,4403088,1968,1734,3,FBtr0077434,FBgn0053003,44
2L,4403337,4403861,524,424,2,FBtr0077435,FBgn0031601,2
2L,4406132,4409353,3221,3075,3,FBtr0077459,FBgn0031602,106
2L,4411157,4411763,606,538,2,FBtr0304637,FBgn0262357,15
2L,4433960,4434397,437,318,3,FBtr0112368,FBgn0085206,6
2L,4434467,4434953,486,333,3,FBtr0112369,FBgn0085207,10
2L,4437819,4438176,357,243,3,FBtr0304638,FBgn0262358,3
2L,4441473,4442051,578,523,2,FBtr0300304,FBgn0259958,7
2L,4442498,4442851,353,353,1,FBtr0077438,FBgn0031603,1
2L,4443073,4444607,1534,1471,2,FBtr0077457,FBgn0027609,41
2L,4444811,4446637,1826,1652,4,FBtr0077439,FBgn0031604,23
2L,4446991,4448427,1436,1314,3,FBtr0077456,FBgn0025684,18
2L,4449519,4452951,3432,3022,2,FBtr0077455,FBgn0031606,62
2L,4453294,4454362,1068,1006,2,FBtr0077454,FBgn0031607,10
2L,4454729,4455135,406,282,3,FBtr0077440,FBgn0040705,26
2L,4455329,4456449,1120,690,3,FBtr0077453,FBgn0019982,17
2L,4457384,4458291,907,444,3,FBtr0077452,FBgn0285948,4
2L,4459007,4459532,525,411,3,FBtr0077451,FBgn0053002,2
2L,4459978,4461556,1578,1507,2,FBtr0077441,FBgn0031608,28
2L,4461827,4462960,1133,1072,2,FBtr0077450,FBgn0031609,46
2L,4463846,4464883,1037,1037,1,FBtr0077442,FBgn0031610,18
2L,4465238,4467931,2693,2571,3,FBtr0077443,FBgn0031611,33
2L,4468137,4474977,6840,2820,9,FBtr0077446,FBgn0011603,52
2L,4479541,4574337,94796,46868,46,FBtr0305141,FBgn0053196,843
2L,4577786,4578103,317,317,1,FBtr0077444,FBgn0031613,14
2L,4641313,4642615,1302,1243,2,FBtr0110769,FBgn0083938,27
2L,4643003,4646469,3466,3406,2,FBtr0300354,FBgn0031617,177
2L,4647100,4647861,761,636,3,FBtr0332006,FBgn0264342,22
2L,4651490,4652773,1283,939,3,FBtr0077376,FBgn0031619,19
2L,4682824,4687102,4278,2754,3,FBtr0077377,FBgn0031620,111
2L,4683227,4684373,1146,1087,2,FBtr0077423,FBgn0000227,25
2L,4687649,4688785,1136,1136,1,FBtr0077378,FBgn0031621,15
2L,4689063,4690600,1537,1483,2,FBtr0077422,FBgn0031622,42
2L,4700995,4701468,473,412,2,FBtr0077420,FBgn0031623,13
2L,4705737,4720450,14713,673,5,FBtr0112561,FBgn0085380,3
2L,4732510,4734426,1916,1864,2,FBtr0077419,FBgn0031626,91
2L,4735550,4793680,58130,1343,7,FBtr0077418,FBgn0031627,21
2L,4762981,4763532,551,551,1,FBtr0300851,FBgn0260428,6
2L,4794672,4796560,1888,1363,5,FBtr0077381,FBgn0031628,51
2L,4797079,4799878,2799,691,2,FBtr0077417,FBgn0031629,9
2L,4813354,4815779,2425,971,4,FBtr0077383,FBgn0031630,14
2L,4815945,4818166,2221,2030,4,FBtr0077416,FBgn0031631,26
2L,4825610,4827569,1959,1088,4,FBtr0077384,FBgn0031632,15
2L,4829487,4830607,1120,990,3,FBtr0077415,FBgn0031633,20
2L,4830971,4834949,3978,2793,9,FBtr0289979,FBgn0031634,31
2L,4835743,4837616,1873,1487,4,FBtr0077412,FBgn0031635,20
2L,4839303,4841005,1702,1450,5,FBtr0077385,FBgn0031636,28
2L,4842237,4846043,3806,1951,8,FBtr0077409,FBgn0031637,36
2L,4847855,4849321,1466,1466,1,FBtr0077386,FBgn0031638,31
2L,4849515,4850363,848,790,2,FBtr0077408,FBgn0031639,24
2L,4850751,4852452,1701,1581,3,FBtr0077387,FBgn0031640,24
2L,4865303,4873622,8319,2360,10,FBtr0077388,FBgn0051660,88
2L,4878859,4882392,3533,1608,3,FBtr0472669,FBgn0000286,38
2L,4883647,4885506,1859,1807,2,FBtr0077389,FBgn0031643,47
2L,4890077,4891184,1107,1045,2,FBtr0077390,FBgn0031644,30
2L,4893955,4903150,9195,1473,6,FBtr0077391,FBgn0031645,31
2L,4904226,4905822,1596,762,3,FBtr0077401,FBgn0031646,17
2L,4909173,4925905,16732,2426,10,FBtr0077395,FBgn0041150,37
2L,4933288,4936341,3053,2531,7,FBtr0077394,FBgn0031649,51
2L,4937441,4941363,3922,3856,2,FBtr0077393,FBgn0003372,173
2L,4942852,4944231,1379,1129,5,FBtr0078990,FBgn0031650,19
2L,4944304,4945275,971,737,4,FBtr0079058,FBgn0031651,13
2L,4945904,4947830,1926,1182,3,FBtr0078991,FBgn0015000,28
2L,4948397,4949673,1276,937,2,FBtr0110896,FBgn0031652,24
2L,4949975,4950748,773,773,1,FBtr0079056,FBgn0031653,13
2L,4952287,4953114,827,827,1,FBtr0079055,FBgn0031654,30
2L,4954326,4955123,797,797,1,FBtr0100432,FBgn0020906,27
2L,4955583,4958220,2637,2258,7,FBtr0078992,FBgn0031655,42
2L,4958478,4965272,6794,5998,11,FBtr0110838,FBgn0083960,63
2L,4965736,4966271,535,475,2,FBtr0110839,FBgn0083961,8
2L,4966484,4967693,1209,975,3,FBtr0079053,FBgn0015834,7
2L,4968010,4968825,815,751,2,FBtr0079052,FBgn0262467,8
2L,4969085,4970143,1058,997,2,FBtr0078994,FBgn0031657,15
2L,4970215,4971296,1081,778,2,FBtr0079050,FBgn0010607,4
2L,4971812,4973611,1799,1799,1,FBtr0078995,FBgn0031659,16
2L,4974137,4975213,1076,903,3,FBtr0078996,FBgn0031660,13
2L,4975582,4976929,1347,1182,3,FBtr0079049,FBgn0031661,17
2L,4977598,4978415,817,754,2,FBtr0078997,FBgn0031662,11
2L,4978569,4979268,699,570,3,FBtr0079048,FBgn0031663,13
2L,4979687,4981174,1487,1487,1,FBtr0079045,FBgn0031664,33
2L,4982029,4991608,9579,4486,17,FBtr0290010,FBgn0083962,63
2L,4994211,5009375,15164,1780,5,FBtr0079038,FBgn0053113,47
2L,5009980,5010432,452,452,1,FBtr0079037,FBgn0031668,12
2L,5010490,5010766,276,217,2,FBtr0301130,FBgn0265968,1
2L,5011190,5011859,669,592,2,FBtr0079000,FBgn0031670,10
2L,5012514,5027129,14615,5812,8,FBtr0079036,FBgn0016075,158
2L,5030218,5036734,6516,5329,8,FBtr0079001,FBgn0000299,109
2L,5038122,5038754,632,632,1,FBtr0110983,FBgn0260451,27
2L,5039111,5040173,1062,900,3,FBtr0079004,FBgn0260470,14
2L,5040885,5042713,1828,1023,3,FBtr0079033,FBgn0031673,23
2L,5044608,5046341,1733,378,3,FBtr0100048,FBgn0053995,4
2L,5046568,5046972,404,404,1,FBtr0334119,FBgn0264742,6
2L,5047104,5047775,671,540,3,FBtr0334124,FBgn0264743,13
2L,5048367,5050877,2510,1797,3,FBtr0079032,FBgn0031675,50
2L,5051316,5052735,1419,1011,3,FBtr0079030,FBgn0022023,11
2L,5053084,5054375,1291,1161,3,FBtr0079009,FBgn0031676,13
2L,5054674,5054952,278,278,1,FBtr0079029,FBgn0031677,3
2L,5055259,5055756,497,406,2,FBtr0079010,FBgn0014857,16
2L,5056250,5058136,1886,1886,1,FBtr0079028,FBgn0031678,40
2L,5058518,5059550,1032,922,2,FBtr0079027,FBgn0028694,12
2L,5062743,5070300,7557,2157,6,FBtr0079012,FBgn0028572,63
2L,5066069,5070437,4368,1871,7,FBtr0332213,FBgn0028572,45
2L,5071155,5071752,597,273,3,FBtr0079016,FBgn0261608,8
2L,5073886,5078988,5102,1882,8,FBtr0079026,FBgn0031681,29
2L,5094106,5095188,1082,1082,1,FBtr0079018,FBgn0031682,17
2L,5096651,5098381,1730,964,5,FBtr0079019,FBgn0031683,14
2L,5099605,5100141,536,375,3,FBtr0079025,FBgn0031684,13
2L,5102798,5205344,102546,35931,27,FBtr0303388,FBgn0261836,521
2L,5109146,5157981,48835,25128,18,FBtr0303383,FBgn0261836,305
2L,5154579,5186159,31580,28814,4,FBtr0303384,FBgn0261836,768
2L,5207308,5209216,1908,1497,6,FBtr0079061,FBgn0031688,20
2L,5210502,5212376,1874,1500,6,FBtr0079062,FBgn0031689,25
2L,5212492,5214586,2094,1520,7,FBtr0079092,FBgn0031690,13
2L,5215286,5216514,1228,1009,5,FBtr0110802,FBgn0250847,14
2L,5218351,5218952,601,444,3,FBtr0079063,FBgn0031692,8
2L,5220096,5271323,51227,1685,4,FBtr0079086,FBgn0003716,32
2L,5264034,5265793,1759,1522,5,FBtr0079066,FBgn0031693,34
2L,5266432,5268319,1887,1528,5,FBtr0300456,FBgn0031694,27
2L,5268546,5270298,1752,1522,5,FBtr0079068,FBgn0031695,48
2L,5272681,5278189,5508,3266,7,FBtr0079084,FBgn0000228,62
2L,5274018,5277325,3307,2303,4,FBtr0302567,FBgn0000228,47
2L,5279360,5282796,3436,3294,3,FBtr0079069,FBgn0031696,72
2L,5306025,5309717,3692,2184,3,FBtr0079071,FBgn0016076,75
2L,5312313,5313884,1571,1329,3,FBtr0079082,FBgn0031697,23
2L,5317213,5325966,8753,7395,6,FBtr0329969,FBgn0031698,217
2L,5327507,5327804,297,229,2,FBtr0079072,FBgn0015031,4
2L,5328078,5328633,555,300,3,FBtr0079080,FBgn0031700,1
2L,5329890,5330338,448,391,2,FBtr0079073,FBgn0031701,12
2L,5330871,5332414,1543,1355,4,FBtr0079078,FBgn0031702,24
2L,5339228,5342055,2827,1776,3,FBtr0079077,FBgn0031703,36
2L,5346858,5365036,18178,5162,16,FBtr0300012,FBgn0016920,65
2L,5404880,5415891,11011,1974,6,FBtr0079076,FBgn0016660,69
2L,5461918,5466709,4791,1736,4,FBtr0079093,FBgn0261963,69
2L,5517842,5518819,977,977,1,FBtr0079094,FBgn0031707,13
2L,5518989,5519812,823,705,3,FBtr0079130,FBgn0031708,15
2L,5520401,5521286,885,375,3,FBtr0079095,FBgn0000318,7
2L,5521381,5523816,2435,1979,7,FBtr0079129,FBgn0031710,6
2L,5524410,5525720,1310,1310,1,FBtr0079096,FBgn0031711,6
2L,5525949,5535754,9805,3794,7,FBtr0079097,FBgn0051989,45
2L,5527075,5527797,722,722,1,FBtr0079098,FBgn0051648,16
2L,5528253,5530161,1908,1834,2,FBtr0079099,FBgn0051915,40
2L,5530717,5532147,1430,1430,1,FBtr0079128,FBgn0031713,35
2L,5535936,5536726,790,727,2,FBtr0079127,FBgn0031715,23
2L,5537463,5539110,1647,1445,4,FBtr0079126,FBgn0031716,46
2L,5539634,5541921,2287,1265,7,FBtr0079123,FBgn0014189,15
2L,5543332,5545505,2173,1863,3,FBtr0079100,FBgn0002525,51
2L,5547815,5549067,1252,815,4,FBtr0079101,FBgn0031717,5
2L,5549824,5550807,983,983,1,FBtr0114511,FBgn0031718,27
2L,5552046,5552645,599,599,1,FBtr0079103,FBgn0031719,4
2L,5552940,5553715,775,721,2,FBtr0079121,FBgn0031720,5
2L,5553978,5554753,775,712,2,FBtr0079104,FBgn0031721,12
2L,5555304,5558694,3390,2709,12,FBtr0079106,FBgn0004620,20
2L,5559451,5563401,3950,2726,13,FBtr0089577,FBgn0020429,30
2L,5579728,5580891,1163,1163,1,FBtr0079118,FBgn0031722,64
2L,5587272,5588291,1019,961,2,FBtr0079117,FBgn0031723,21
2L,5596939,5598396,1457,1457,1,FBtr0079109,FBgn0031724,31
2L,5602977,5613494,10517,1339,11,FBtr0302933,FBgn0031725,37
2L,5621605,5623740,2135,1486,3,FBtr0343243,FBgn0031726,77
2L,5626924,5651916,24992,1806,12,FBtr0079114,FBgn0051646,34
2L,5668949,5670676,1727,1727,1,FBtr0079110,FBgn0031728,24
2L,5678698,5679147,449,391,2,FBtr0302949,FBgn0031729,15
2L,5706752,5713550,6798,1259,4,FBtr0343389,FBgn0031730,24
2L,5715494,5716650,1156,910,5,FBtr0343392,FBgn0031731,21
2L,5716960,5718064,1104,823,5,FBtr0343391,FBgn0054011,22
2L,5718404,5719962,1558,1477,2,FBtr0079168,FBgn0031732,24
2L,5721136,5723766,2630,2514,3,FBtr0079134,FBgn0024191,69
2L,5725220,5759807,34587,992,4,FBtr0079135,FBgn0031736,19
2L,5727466,5728752,1286,1286,1,FBtr0079167,FBgn0031733,34
2L,5734132,5736924,2792,2124,9,FBtr0079165,FBgn0031734,29
2L,5746277,5747617,1340,1340,1,FBtr0079136,FBgn0031735,17
2L,5762677,5766015,3338,745,2,FBtr0079164,FBgn0031737,25
2L,5769319,5771202,1883,1627,5,FBtr0301234,FBgn0031738,34
2L,5784120,5784764,644,644,1,FBtr0079138,FBgn0051913,11
2L,5800873,5801886,1013,949,2,FBtr0079160,FBgn0031739,37
2L,5802405,5803840,1435,1375,2,FBtr0079139,FBgn0031740,44
2L,5805479,5808855,3376,2247,6,FBtr0306841,FBgn0031741,68
2L,5811593,5811897,304,247,2,FBtr0306842,FBgn0262999,3
2L,5818051,5818385,334,259,2,FBtr0079159,FBgn0051644,5
2L,5845352,5856451,11099,1998,9,FBtr0112619,FBgn0085410,81
2L,5860183,5861607,1424,1287,3,FBtr0079158,FBgn0031745,31
2L,5883782,5884316,534,420,3,FBtr0342613,FBgn0265785,30
2L,5884384,5884751,367,249,3,FBtr0300305,FBgn0259959,4
2L,5885173,5885396,223,160,2,FBtr0344574,FBgn0262814,13
2L,5886020,5886432,412,346,2,FBtr0079143,FBgn0031746,7
2L,5892507,5892837,330,268,2,FBtr0079156,FBgn0002856,3
2L,5893024,5893871,847,790,2,FBtr0079155,FBgn0002855,20
2L,5903584,5904661,1077,946,2,FBtr0079154,FBgn0031747,37
2L,5908345,5921239,12894,10450,17,FBtr0079144,FBgn0043362,128
2L,5909051,5910244,1193,1193,1,FBtr0079153,FBgn0031749,22
2L,5923217,5923471,254,254,1,FBtr0079151,FBgn0031751,22
2L,5926192,5938052,11860,2068,5,FBtr0079145,FBgn0015381,111
2L,5942822,5943254,432,361,2,FBtr0301935,FBgn0261055,12
2L,5944110,5947887,3777,1073,7,FBtr0079146,FBgn0001128,17
2L,5949900,5954998,5098,3877,8,FBtr0273412,FBgn0031752,61
2L,5955617,5956225,608,492,3,FBtr0079150,FBgn0031753,13
2L,5956515,5956805,290,290,1,FBtr0079241,FBgn0040949,15
2L,5957066,5957569,503,503,1,FBtr0079171,FBgn0003980,32
2L,5958049,5958591,542,542,1,FBtr0079240,FBgn0086266,24
2L,5959837,5960259,422,422,1,FBtr0079239,FBgn0003979,19
2L,5963141,5964283,1142,1142,1,FBtr0079238,FBgn0086265,38
2L,5965522,5967498,1976,1976,1,FBtr0079237,FBgn0031756,74
2L,5968683,5969687,1004,1004,1,FBtr0079172,FBgn0031757,25
2L,5969902,5970981,1079,1009,2,FBtr0079173,FBgn0031758,35
2L,5973580,5979522,5942,375,3,FBtr0079233,FBgn0000308,5
2L,5981834,5985167,3333,1204,5,FBtr0079175,FBgn0001942,17
2L,5986495,5988180,1685,961,2,FBtr0079179,FBgn0001941,18
2L,5990645,5996490,5845,5510,4,FBtr0079231,FBgn0031759,61
2L,6000312,6001734,1422,936,6,FBtr0113024,FBgn0031760,8
2L,6003765,6006689,2924,2010,6,FBtr0079230,FBgn0001089,33
2L,6007911,6012236,4325,2823,9,FBtr0079228,FBgn0031762,80
2L,6013258,6019193,5935,1251,3,FBtr0079227,FBgn0001170,62
2L,6020850,6021669,819,766,2,FBtr0079181,FBgn0031763,23
2L,6023612,6024464,852,796,2,FBtr0079225,FBgn0031764,35
2L,6031307,6034323,3016,1599,6,FBtr0079224,FBgn0031765,66
2L,6034900,6036811,1911,1855,2,FBtr0079223,FBgn0025742,33
2L,6037132,6037815,683,683,1,FBtr0079222,FBgn0031766,23
2L,6038203,6041128,2925,2692,5,FBtr0079182,FBgn0051643,32
2L,6041317,6045517,4200,4059,3,FBtr0079219,FBgn0000052,110
2L,6047056,6047700,644,644,1,FBtr0079217,FBgn0029161,27
2L,6047742,6048643,901,547,2,FBtr0344625,FBgn0085208,18
2L,6048877,6050345,1468,884,4,FBtr0079183,FBgn0031768,18
2L,6051678,6053255,1577,1458,3,FBtr0079185,FBgn0031769,19
2L,6057054,6059007,1953,1631,4,FBtr0079187,FBgn0031770,42
2L,6060544,6060824,280,226,2,FBtr0300048,FBgn0085209,12
2L,6060940,6062687,1747,1418,4,FBtr0079216,FBgn0031771,18
2L,6063023,6063563,540,487,2,FBtr0079188,FBgn0031772,18
2L,6063691,6065765,2074,1965,3,FBtr0079215,FBgn0031773,31
2L,6066278,6067559,1281,1170,3,FBtr0079189,FBgn0031774,38
2L,6067770,6068579,809,751,2,FBtr0302213,FBgn0031775,20
2L,6069221,6069763,542,375,3,FBtr0079191,FBgn0031776,1
2L,6069811,6070589,778,666,3,FBtr0079213,FBgn0031777,20
2L,6072456,6073459,1003,824,4,FBtr0079192,FBgn0266449,13
2L,6091569,6091817,248,248,1,FBtr0344439,FBgn0266445,4
2L,6092100,6095553,3453,2531,4,FBtr0344438,FBgn0266450,82
2L,6097171,6098696,1525,1331,4,FBtr0079211,FBgn0031779,48
2L,6101771,6123061,21290,765,6,FBtr0079196,FBgn0266521,10
2L,6118758,6120428,1670,1670,1,FBtr0079199,FBgn0051642,54
2L,6125249,6125752,503,503,1,FBtr0079200,FBgn0284255,19
2L,6125935,6127619,1684,1508,4,FBtr0333407,FBgn0031782,44
2L,6127914,6129884,1970,1970,1,FBtr0303079,FBgn0261697,93
2L,6129890,6130550,660,528,3,FBtr0303078,FBgn0261683,20
2L,6131187,6132369,1182,1007,4,FBtr0079201,FBgn0031784,5
2L,6139549,6144849,5300,5300,1,FBtr0079202,FBgn0031785,89
2L,6152048,6153523,1475,1411,2,FBtr0079203,FBgn0040950,25
2L,6154702,6154875,173,173,1,FBtr0079207,FBgn0051639,2
2L,6160532,6160936,404,404,1,FBtr0079204,FBgn0031786,17
2L,6190471,6208380,17909,2305,11,FBtr0112617,FBgn0085409,78
2L,6225079,6226744,1665,1609,2,FBtr0079242,FBgn0026755,32
2L,6255876,6256523,647,647,1,FBtr0079243,FBgn0031791,21
2L,6263638,6264453,815,757,2,FBtr0079285,FBgn0031792,24
2L,6272817,6291408,18591,1134,6,FBtr0340169,FBgn0053531,29
2L,6308460,6308702,242,242,1,FBtr0333243,FBgn0264543,7
2L,6308867,6309166,299,299,1,FBtr0079247,FBgn0260452,8
2L,6325268,6330640,5372,4714,5,FBtr0079249,FBgn0265778,75
2L,6333296,6338142,4846,3749,7,FBtr0079284,FBgn0031799,61
2L,6342174,6345884,3710,2031,6,FBtr0079250,FBgn0015623,28
2L,6346677,6348151,1474,1248,3,FBtr0079283,FBgn0031800,23
2L,6349562,6350961,1399,1269,3,FBtr0079282,FBgn0031801,15
2L,6352327,6354331,2004,1714,5,FBtr0079281,FBgn0031802,60
2L,6354956,6356669,1713,1508,4,FBtr0346719,FBgn0031803,26
2L,6357254,6358235,981,812,4,FBtr0079280,FBgn0031804,36
2L,6368141,6370096,1955,1955,1,FBtr0079253,FBgn0031805,44
2L,6373577,6377161,3584,3517,2,FBtr0290281,FBgn0043854,82
2L,6378843,6408383,29540,1392,9,FBtr0299967,FBgn0259714,21
2L,6381298,6383349,2051,2051,1,FBtr0079255,FBgn0031808,55
2L,6383548,6385512,1964,1964,1,FBtr0299969,FBgn0259716,40
2L,6395891,6397093,1202,1202,1,FBtr0299968,FBgn0259715,38
2L,6412704,6414068,1364,984,3,FBtr0079256,FBgn0031811,41
2L,6415439,6422509,7070,6559,5,FBtr0079275,FBgn0011722,127
2L,6424526,6426119,1593,1473,3,FBtr0079257,FBgn0263278,14
2L,6445122,6447961,2839,2100,9,FBtr0089948,FBgn0031813,41
2L,6449711,6455597,5886,2115,6,FBtr0329951,FBgn0031814,46
2L,6456471,6458582,2111,1461,6,FBtr0079258,FBgn0031815,33
2L,6459531,6463843,4312,1294,5,FBtr0079271,FBgn0031816,43
2L,6466527,6467608,1081,966,3,FBtr0079270,FBgn0031817,25
2L,6468848,6473691,4843,1557,3,FBtr0079268,FBgn0259749,28
2L,6474802,6476745,1943,1347,3,FBtr0079267,FBgn0031818,43
2L,6477637,6480330,2693,1424,4,FBtr0079266,FBgn0086357,9
2L,6481200,6487106,5906,4973,4,FBtr0079260,FBgn0031820,250
2L,6487600,6488551,951,898,2,FBtr0079265,FBgn0031821,10
2L,6489191,6490108,917,917,1,FBtr0079261,FBgn0027496,24
2L,6490219,6490757,538,329,4,FBtr0079264,FBgn0031822,2
2L,6491235,6496062,4827,2103,9,FBtr0079262,FBgn0051638,29
2L,6493064,6494438,1374,1255,2,FBtr0079263,FBgn0031824,25
2L,6497134,6498338,1204,1086,3,FBtr0079286,FBgn0031826,24
2L,6498876,6526011,27135,1454,4,FBtr0079287,FBgn0051637,51
2L,6528013,6546502,18489,2275,5,FBtr0079334,FBgn0000320,106
2L,6555814,6557359,1545,1227,3,FBtr0079333,FBgn0031829,14
2L,6557903,6559042,1139,357,3,FBtr0079288,FBgn0031830,2
2L,6559531,6560048,517,460,2,FBtr0079289,FBgn0031831,4
2L,6560176,6561567,1391,1330,2,FBtr0079332,FBgn0031832,23
2L,6562697,6564070,1373,1373,1,FBtr0079290,FBgn0263916,28
2L,6565173,6566117,944,944,1,FBtr0079330,FBgn0031834,12
2L,6572489,6586530,14041,2791,14,FBtr0089641,FBgn0031835,54
2L,6612566,6616510,3944,1160,4,FBtr0079291,FBgn0031836,29
2L,6617143,6621510,4367,1122,6,FBtr0113026,FBgn0031837,14
2L,6623123,6625105,1982,1504,8,FBtr0112553,FBgn0085374,55
2L,6625391,6632318,6927,2069,7,FBtr0079327,FBgn0051634,48
2L,6634814,6646668,11854,5339,7,FBtr0113410,FBgn0051635,93
2L,6649533,6654330,4797,4283,7,FBtr0079295,FBgn0031842,73
2L,6654900,6656233,1333,1221,3,FBtr0079325,FBgn0051633,28
2L,6656673,6657738,1065,936,3,FBtr0079324,FBgn0051636,13
2L,6658592,6661696,3104,2976,3,FBtr0079297,FBgn0028467,37
2L,6662100,6663577,1477,1350,3,FBtr0079323,FBgn0031844,23
2L,6664150,6674311,10161,3345,6,FBtr0290322,FBgn0000392,48
2L,6666354,6667689,1335,1046,4,FBtr0079322,FBgn0263200,12
2L,6671835,6673175,1340,1340,1,FBtr0079321,FBgn0028990,20
2L,6674059,6674522,463,385,2,FBtr0347411,FBgn0085339,6
2L,6674803,6676550,1747,1443,6,FBtr0079320,FBgn0000351,12
2L,6676844,6677548,704,704,1,FBtr0079319,FBgn0031848,16
2L,6678150,6683948,5798,2075,13,FBtr0300327,FBgn0028703,28
2L,6679926,6682814,2888,1801,11,FBtr0333347,FBgn0028703,21
2L,6685070,6686494,1424,1424,1,FBtr0079315,FBgn0031849,26
2L,6686928,6701834,14906,3168,12,FBtr0079312,FBgn0031850,51
2L,6711706,6714691,2985,1359,6,FBtr0079310,FBgn0025595,34
2L,6717711,6719236,1525,1462,2,FBtr0079299,FBgn0031851,45
2L,6720562,6723197,2635,1586,7,FBtr0329893,FBgn0025777,26
2L,6724848,6730685,5837,3589,14,FBtr0079300,FBgn0046704,66
2L,6733249,6735672,2423,2265,3,FBtr0300056,FBgn0031853,30
2L,6736452,6740176,3724,2972,4,FBtr0079305,FBgn0031854,92
2L,6743017,6755294,12277,1366,2,FBtr0079303,FBgn0031855,34
2L,6744702,6745542,840,784,2,FBtr0079304,FBgn0051910,16
2L,6747526,6747843,317,317,1,FBtr0339238,FBgn0265257,8
2L,6758055,6759494,1439,1439,1,FBtr0290242,FBgn0031856,48
2L,6760193,6770644,10451,8660,16,FBtr0331216,FBgn0031857,339
2L,6774693,6777730,3037,1824,6,FBtr0079336,FBgn0031858,44
2L,6779376,6786414,7038,923,4,FBtr0079384,FBgn0015776,8
2L,6790642,6796481,5839,963,6,FBtr0079381,FBgn0015777,11
2L,6800104,6800681,577,199,2,FBtr0079380,FBgn0042189,1
2L,6801643,6802637,994,540,3,FBtr0309814,FBgn0031859,38
2L,6803052,6804255,1203,1019,4,FBtr0079339,FBgn0031860,30
2L,6804681,6805677,996,800,4,FBtr0300821,FBgn0031861,8
2L,6822600,6838155,15555,2233,5,FBtr0079341,FBgn0051632,118
2L,6852422,6853654,1232,1232,1,FBtr0079342,FBgn0017551,22
2L,6854246,6860769,6523,6284,4,FBtr0079343,FBgn0086451,143
2L,6861037,6864340,3303,2119,5,FBtr0079373,FBgn0031865,59
2L,6897428,6905989,8561,3732,12,FBtr0079344,FBgn0031866,90
2L,6906921,6907777,856,757,2,FBtr0079372,FBgn0042092,12
2L,6908166,6910889,2723,2723,1,FBtr0079345,FBgn0031868,27
2L,6911704,6913927,2223,1822,5,FBtr0079371,FBgn0011737,25
2L,6915046,6919942,4896,772,2,FBtr0079368,FBgn0028554,37
2L,6915686,6916387,701,701,1,FBtr0079370,FBgn0052829,11
2L,6916901,6918611,1710,1531,2,FBtr0079369,FBgn0026196,32
2L,6923906,6925452,1546,1261,2,FBtr0079346,FBgn0004838,32
2L,6932251,6932460,209,148,2,FBtr0306284,FBgn0262877,3
2L,6932688,6940918,8230,5670,15,FBtr0079367,FBgn0031869,111
2L,6944052,6944996,944,944,1,FBtr0079366,FBgn0031871,25
2L,6945756,6948413,2657,2657,1,FBtr0079365,FBgn0031872,64
2L,6949378,6950116,738,679,2,FBtr0079364,FBgn0031873,3
2L,6950539,6954451,3912,3371,10,FBtr0079349,FBgn0020616,14
2L,6954588,6956872,2284,1830,3,FBtr0079363,FBgn0031874,34
2L,6957098,6959036,1938,1812,3,FBtr0079350,FBgn0031875,25
2L,6959186,6960253,1067,1067,1,FBtr0079362,FBgn0031876,20
2L,6960443,6961470,1027,967,2,FBtr0079351,FBgn0031877,27
2L,6961594,6963532,1938,1873,2,FBtr0079357,FBgn0031878,30
2L,6964519,6965688,1169,1169,1,FBtr0079352,FBgn0021944,29
2L,6967031,6967300,269,269,1,FBtr0079356,FBgn0264922,0
2L,6970119,6971462,1343,1343,1,FBtr0079355,FBgn0016978,68
2L,6973480,6999856,26376,10660,11,FBtr0290119,FBgn0031879,204
2L,7012327,7012521,194,194,1,FBtr0306925,FBgn0263026,2
2L,7013496,7014642,1146,1075,2,FBtr0306926,FBgn0263027,29
2L,7015089,7023705,8616,4052,7,FBtr0079431,FBgn0000053,117
2L,7021715,7022337,622,550,2,FBtr0079388,FBgn0003046,10
2L,7025176,7026777,1601,1173,3,FBtr0079429,FBgn0051908,52
2L,7027811,7028896,1085,893,4,FBtr0079389,FBgn0031881,17
2L,7031437,7032105,668,668,1,FBtr0079426,FBgn0031882,22
2L,7032965,7037447,4482,1777,5,FBtr0089636,FBgn0031883,51
2L,7040606,7054553,13947,3343,5,FBtr0306228,FBgn0262872,73
2L,7057407,7061718,4311,2285,4,FBtr0079401,FBgn0031885,75
2L,7059438,7060709,1271,1271,1,FBtr0079425,FBgn0051907,18
2L,7064086,7064377,291,235,2,FBtr0079403,FBgn0266666,4
2L,7064464,7065765,1301,1182,3,FBtr0079424,FBgn0031886,26
2L,7067983,7069539,1556,1504,2,FBtr0289952,FBgn0031887,54
2L,7070164,7083623,13459,1211,4,FBtr0079423,FBgn0031888,18
2L,7100096,7156665,56569,1947,6,FBtr0112611,FBgn0085407,46
2L,7182347,7185289,2942,1564,8,FBtr0079405,FBgn0031893,19
2L,7185832,7187636,1804,1738,2,FBtr0079419,FBgn0031894,31
2L,7191405,7193363,1958,1516,2,FBtr0079418,FBgn0031895,48
2L,7195559,7196674,1115,914,4,FBtr0079416,FBgn0031896,19
2L,7205961,7219111,13150,2901,6,FBtr0330199,FBgn0031897,56
2L,7220536,7222980,2444,2231,4,FBtr0079413,FBgn0263133,27
2L,7223619,7237780,14161,3392,10,FBtr0331658,FBgn0259111,54
2L,7223632,7240210,16578,3128,10,FBtr0331664,FBgn0259111,44
2L,7227763,7228563,800,745,2,FBtr0332003,FBgn0264343,25
2L,7232230,7232610,380,380,1,FBtr0332004,FBgn0264344,6
2L,7250722,7252772,2050,1856,4,FBtr0333353,FBgn0031900,73
2L,7256007,7276009,20002,1613,4,FBtr0089291,FBgn0010453,33
2L,7257732,7258112,380,380,1,FBtr0300459,FBgn0051909,1
2L,7307592,7315183,7591,1399,5,FBtr0079432,FBgn0284084,32
2L,7335044,7352277,17233,1256,4,FBtr0303251,FBgn0031902,24
2L,7364820,7377256,12436,1443,6,FBtr0303207,FBgn0031903,49
2L,7378401,7384184,5783,4490,13,FBtr0079436,FBgn0002938,50
2L,7384890,7388103,3213,1337,7,FBtr0079469,FBgn0031904,7
2L,7388676,7390825,2149,2004,3,FBtr0079438,FBgn0031905,14
2L,7391078,7392382,1304,979,5,FBtr0079468,FBgn0031906,10
2L,7401438,7404361,2923,884,4,FBtr0302587,FBgn0031907,12
2L,7405318,7408396,3078,824,4,FBtr0079441,FBgn0031908,3
2L,7409030,7409704,674,610,2,FBtr0079467,FBgn0031909,22
2L,7410955,7411803,848,848,1,FBtr0079442,FBgn0031910,8
2L,7412507,7421957,9450,2425,8,FBtr0079443,FBgn0028387,36
2L,7427201,7429869,2668,1529,7,FBtr0079444,FBgn0283658,28
2L,7430676,7433176,2500,879,3,FBtr0079466,FBgn0031913,15
2L,7443646,7444970,1324,926,7,FBtr0079446,FBgn0031914,9
2L,7445632,7447647,2015,1685,4,FBtr0079464,FBgn0025697,23
2L,7452544,7454169,1625,1347,3,FBtr0079463,FBgn0041247,12
2L,7455011,7462247,7236,1353,3,FBtr0079458,FBgn0045495,24
2L,7471546,7472202,656,656,1,FBtr0079449,FBgn0031918,10
2L,7473114,7495608,22494,6880,14,FBtr0332201,FBgn0260486,72
2L,7474907,7476836,1929,1670,4,FBtr0079451,FBgn0031920,17
2L,7496901,7497329,428,428,1,FBtr0079455,FBgn0011283,13
2L,7499028,7568818,69790,2794,5,FBtr0334846,FBgn0264895,77
2L,7581935,7583230,1295,1130,4,FBtr0079470,FBgn0083141,23
2L,7605682,7607495,1813,1528,5,FBtr0079471,FBgn0031925,26
2L,7613405,7616323,2918,2356,5,FBtr0079472,FBgn0031926,72
2L,7643530,7656100,12570,3828,12,FBtr0330705,FBgn0264087,60
2L,7666077,7689412,23335,6356,10,FBtr0079473,FBgn0040299,113
2L,7689450,7691043,1593,1261,5,FBtr0079516,FBgn0031929,23
2L,7691158,7692669,1511,1282,5,FBtr0079515,FBgn0031930,22
2L,7693143,7693565,422,306,3,FBtr0306288,FBgn0262880,8
2L,7693911,7701421,7510,4252,8,FBtr0079510,FBgn0041182,102
2L,7703147,7710511,7364,4392,15,FBtr0079477,FBgn0041181,82
2L,7711026,7713838,2812,1761,9,FBtr0079478,FBgn0267326,12
2L,7714100,7716553,2453,1746,9,FBtr0302519,FBgn0053296,37
2L,7717055,7719390,2335,1740,9,FBtr0302518,FBgn0031935,35
2L,7719911,7722645,2734,1776,9,FBtr0079507,FBgn0031936,34
2L,7723559,7726095,2536,1773,9,FBtr0300709,FBgn0031937,19
2L,7727500,7730558,3058,1913,10,FBtr0079503,FBgn0031939,33
2L,7734667,7736698,2031,1205,4,FBtr0079501,FBgn0260479,46
2L,7740959,7741481,522,403,2,FBtr0079500,FBgn0014454,27
2L,7744211,7744753,542,424,2,FBtr0079499,FBgn0031940,16
2L,7747381,7747754,373,319,2,FBtr0079481,FBgn0031941,8
2L,7752434,7753107,673,385,2,FBtr0290272,FBgn0031942,18
2L,7754335,7765363,11028,1315,8,FBtr0347187,FBgn0267689,11
2L,7771320,7774393,3073,851,4,FBtr0079485,FBgn0031945,25
2L,7775898,7777985,2087,2087,1,FBtr0301151,FBgn0020880,57
2L,7780118,7781242,1124,1054,2,FBtr0079486,FBgn0003961,9
2L,7781635,7782537,902,841,2,FBtr0079487,FBgn0031946,23
2L,7782991,7785936,2945,2579,4,FBtr0079488,FBgn0031947,30
2L,7786341,7790078,3737,1233,9,FBtr0343405,FBgn0031948,10
2L,7791761,7795834,4073,2776,8,FBtr0079495,FBgn0286198,28
2L,7796933,7799512,2579,1391,4,FBtr0079493,FBgn0031950,45
2L,7800503,7801508,1005,931,2,FBtr0079489,FBgn0031951,35
2L,7802490,7807044,4554,3150,6,FBtr0079492,FBgn0031952,83
2L,7814948,7820387,5439,5362,2,FBtr0079490,FBgn0261800,52
2L,7821269,7824880,3611,1401,6,FBtr0331234,FBgn0027515,29
2L,7825704,7827169,1465,951,3,FBtr0079565,FBgn0020618,11
2L,7828052,7831803,3751,923,4,FBtr0079525,FBgn0004177,9
2L,7840539,7841147,608,608,1,FBtr0079526,FBgn0031954,8
2L,7846821,7853301,6480,3387,6,FBtr0079564,FBgn0031955,93
2L,7857121,7857875,754,754,1,FBtr0308065,FBgn0040099,32
2L,7858573,7860700,2127,588,3,FBtr0079563,FBgn0031957,18
2L,7865907,7870443,4536,418,2,FBtr0079562,FBgn0045038,13
2L,7873808,7879146,5338,1828,5,FBtr0079561,FBgn0031959,39
2L,7883540,7887052,3512,1539,6,FBtr0079559,FBgn0031961,29
2L,7885062,7885343,281,281,1,FBtr0079560,FBgn0261790,3
2L,7885649,7885972,323,250,2,FBtr0110879,FBgn0083968,2
2L,7887794,7889112,1318,1148,4,FBtr0110841,FBgn0051902,46
2L,7889374,7890530,1156,1035,3,FBtr0079557,FBgn0053121,25
2L,7894088,7976190,82102,3667,2,FBtr0112717,FBgn0085450,124
2L,7984768,7986702,1934,1070,4,FBtr0300185,FBgn0031968,28
2L,7987880,7991480,3600,1661,4,FBtr0114550,FBgn0031969,25
2L,7995010,7996752,1742,1550,4,FBtr0079551,FBgn0031970,37
2L,7999113,7999547,434,352,2,FBtr0079532,FBgn0031971,19
2L,7999847,8004188,4341,1221,6,FBtr0079550,FBgn0031972,34
2L,8004654,8007132,2478,1606,2,FBtr0079549,FBgn0031973,61
2L,8008445,8009459,1014,830,4,FBtr0300761,FBgn0031974,22
2L,8009628,8010635,1007,830,4,FBtr0100065,FBgn0054010,35
2L,8011745,8026769,15024,2325,3,FBtr0079533,FBgn0031975,50
2L,8027012,8028691,1679,1070,4,FBtr0301128,FBgn0031976,15
2L,8029608,8029959,351,268,2,FBtr0079535,FBgn0031977,1
2L,8032258,8038198,5940,2186,4,FBtr0079536,FBgn0044323,65
2L,8041149,8041795,646,525,3,FBtr0079540,FBgn0031979,32
2L,8041991,8042825,834,309,3,FBtr0079546,FBgn0031980,7
2L,8043715,8053045,9330,8670,6,FBtr0344788,FBgn0031981,123
2L,8054514,8071566,17052,15953,13,FBtr0079545,FBgn0011230,204
2L,8071958,8072761,803,803,1,FBtr0329946,FBgn0013531,15
2L,8072971,8073713,742,670,2,FBtr0079542,FBgn0010287,17
2L,8074959,8080610,5651,5274,6,FBtr0079543,FBgn0267488,56
2L,8089664,8107881,18217,789,6,FBtr0079566,FBgn0261822,6
2L,8117523,8123814,6291,5039,13,FBtr0301229,FBgn0031985,79
2L,8124392,8125718,1326,1258,2,FBtr0079575,FBgn0031986,25
2L,8125806,8126681,875,875,1,FBtr0079642,FBgn0031987,25
2L,8131426,8133640,2214,1752,3,FBtr0079576,FBgn0031988,36
2L,8134626,8159432,24806,6041,7,FBtr0079641,FBgn0031990,237
2L,8143491,8144027,536,481,2,FBtr0303390,FBgn0261830,25
2L,8144459,8145088,629,571,2,FBtr0303391,FBgn0261831,17
2L,8147630,8148276,646,589,2,FBtr0079577,FBgn0051606,13
2L,8152635,8155113,2478,1607,4,FBtr0308298,FBgn0263256,27
2L,8160092,8161729,1637,1512,3,FBtr0079581,FBgn0261064,30
2L,8161924,8162325,401,267,3,FBtr0079640,FBgn0031992,3
2L,8173146,8189126,15980,8098,29,FBtr0335175,FBgn0264953,129
2L,8190384,8190740,356,356,1,FBtr0110894,FBgn0083970,15
2L,8191142,8196815,5673,3269,10,FBtr0079638,FBgn0031995,25
2L,8197293,8198751,1458,1201,5,FBtr0079586,FBgn0031996,19
2L,8199043,8200278,1235,1098,3,FBtr0079587,FBgn0031997,7
2L,8200888,8204695,3807,1790,10,FBtr0079637,FBgn0031998,17
2L,8206279,8209268,2989,2758,5,FBtr0079589,FBgn0031999,38
2L,8209838,8210843,1005,614,4,FBtr0079635,FBgn0003607,7
2L,8211446,8211831,385,328,2,FBtr0079590,FBgn0015299,3
2L,8212122,8212655,533,533,1,FBtr0079633,FBgn0032000,13
2L,8213219,8213997,778,471,3,FBtr0089935,FBgn0032001,5
2L,8214418,8215111,693,508,2,FBtr0079593,FBgn0032002,5
2L,8215986,8216836,850,790,2,FBtr0079594,FBgn0032003,11
2L,8216977,8217899,922,859,2,FBtr0079632,FBgn0032004,13
2L,8218414,8220628,2214,1340,7,FBtr0079631,FBgn0032005,14
2L,8221552,8230194,8642,4510,17,FBtr0079625,FBgn0032006,65
2L,8240468,8241766,1298,1121,4,FBtr0079624,FBgn0028987,16
2L,8242667,8243289,622,504,3,FBtr0079595,FBgn0032008,6
2L,8243516,8243988,472,366,3,FBtr0304640,FBgn0262359,12
2L,8244391,8252706,8315,779,4,FBtr0332362,FBgn0032010,5
2L,8245220,8252851,7631,4694,13,FBtr0306391,FBgn0032010,120
2L,8260541,8272077,11536,1800,9,FBtr0079615,FBgn0003502,11
2L,8301540,8302823,1283,974,4,FBtr0079614,FBgn0261020,18
2L,8303541,8305160,1619,1324,5,FBtr0079597,FBgn0032013,21
2L,8305685,8306662,977,977,1,FBtr0079598,FBgn0032014,15
2L,8306828,8308069,1241,986,4,FBtr0079613,FBgn0032015,11
2L,8308544,8309862,1318,1188,3,FBtr0079599,FBgn0032016,11
2L,8310032,8311123,1091,1091,1,FBtr0079612,FBgn0032017,24
2L,8311569,8316670,5101,4456,5,FBtr0079600,FBgn0032018,57
2L,8317211,8319676,2465,1942,5,FBtr0301170,FBgn0262598,16
2L,8320409,8320844,435,364,2,FBtr0079601,FBgn0032020,5
2L,8322491,8325013,2522,438,3,FBtr0079609,FBgn0032021,16
2L,8329704,8332690,2986,442,2,FBtr0079602,FBgn0032022,17
2L,8338440,8341162,2722,557,4,FBtr0079604,FBgn0032023,11
2L,8342929,8344307,1378,753,3,FBtr0079605,FBgn0032024,27
2L,8346805,8349952,3147,804,3,FBtr0079606,FBgn0032025,32
2L,8352308,8355074,2766,1661,4,FBtr0079607,FBgn0051901,47
2L,8355939,8361177,5238,4056,9,FBtr0079608,FBgn0032026,53
2L,8363824,8364563,739,450,3,FBtr0079724,FBgn0010265,3
2L,8364923,8365636,713,542,4,FBtr0079646,FBgn0261437,8
2L,8366311,8369717,3406,1766,7,FBtr0005088,FBgn0260439,14
2L,8372598,8374125,1527,1015,5,FBtr0079648,FBgn0032029,10
2L,8374527,8375477,950,950,1,FBtr0079650,FBgn0032030,12
2L,8375565,8376773,1208,1141,2,FBtr0079723,FBgn0032031,14
2L,8377084,8378008,924,761,4,FBtr0079651,FBgn0032032,10
2L,8378422,8381442,3020,2896,2,FBtr0079721,FBgn0027094,36
2L,8381974,8382707,733,667,2,FBtr0079720,FBgn0032033,12
2L,8382956,8383616,660,595,2,FBtr0079652,FBgn0032034,4
2L,8383677,8384012,335,335,1,FBtr0079719,FBgn0263852,0
2L,8384860,8388132,3272,1507,5,FBtr0079655,FBgn0032036,9
2L,8388832,8389269,437,437,1,FBtr0303800,FBgn0262001,13
2L,8390088,8392295,2207,2064,3,FBtr0303799,FBgn0262002,63
2L,8392510,8393211,701,701,1,FBtr0079716,FBgn0015583,17
2L,8393563,8394270,707,707,1,FBtr0079715,FBgn0040098,17
2L,8394536,8394881,345,277,2,FBtr0079714,FBgn0040958,9
2L,8395716,8396062,346,274,2,FBtr0079713,FBgn0040959,10
2L,8396740,8397798,1058,1058,1,FBtr0079660,FBgn0032039,29
2L,8399044,8399969,925,850,2,FBtr0079661,FBgn0032040,29
2L,8400476,8401474,998,998,1,FBtr0079662,FBgn0051898,28
2L,8401717,8403081,1364,1245,3,FBtr0079712,FBgn0001084,23
2L,8404288,8407921,3633,3183,6,FBtr0079663,FBgn0020497,10
2L,8409132,8411544,2412,2332,2,FBtr0079711,FBgn0014417,42
2L,8413554,8414879,1325,1325,1,FBtr0079710,FBgn0032042,20
2L,8426911,8430364,3453,2254,5,FBtr0079664,FBgn0027932,86
2L,8431545,8433082,1537,882,3,FBtr0079708,FBgn0001137,20
2L,8434212,8437175,2963,2905,2,FBtr0079707,FBgn0027490,55
2L,8437505,8437888,383,383,1,FBtr0100268,FBgn0043002,4
2L,8438376,8442307,3931,3704,4,FBtr0100473,FBgn0002887,71
2L,8442643,8445657,3014,3014,1,FBtr0079673,FBgn0051897,97
2L,8446095,8449424,3329,3030,6,FBtr0089673,FBgn0027780,69
2L,8450092,8450969,877,811,2,FBtr0079703,FBgn0026718,8
2L,8464610,8466341,1731,1672,2,FBtr0079674,FBgn0285971,22
2L,8476291,8488212,11921,4270,8,FBtr0303924,FBgn0262029,101
2L,8477354,8477947,593,538,2,FBtr0079676,FBgn0053194,8
2L,8482478,8482858,380,380,1,FBtr0332009,FBgn0264340,5
2L,8489031,8490345,1314,1200,3,FBtr0079681,FBgn0032047,29
2L,8490826,8491219,393,334,2,FBtr0308708,FBgn0263314,13
2L,8492670,8493835,1165,345,3,FBtr0079699,FBgn0032048,6
2L,8495153,8496268,1115,1115,1,FBtr0079701,FBgn0032049,17
2L,8509378,8511768,2390,2041,2,FBtr0079698,FBgn0032050,29
2L,8512596,8514754,2158,1983,3,FBtr0079697,FBgn0032051,41
2L,8515153,8516612,1459,1274,4,FBtr0079682,FBgn0032052,18
2L,8516771,8517292,521,521,1,FBtr0079696,FBgn0032053,3
2L,8517667,8519025,1358,1358,1,FBtr0079683,FBgn0032054,20
2L,8519717,8521609,1892,1564,5,FBtr0079684,FBgn0032055,26
2L,8522278,8524777,2499,1886,4,FBtr0079685,FBgn0016122,24
2L,8526865,8527959,1094,1094,1,FBtr0112744,FBgn0085470,49
2L,8528055,8528309,254,254,1,FBtr0079695,FBgn0250903,2
2L,8536060,8541233,5173,1264,5,FBtr0079686,FBgn0028394,26
2L,8564059,8666208,102149,2677,20,FBtr0079691,FBgn0011259,29
2L,8673202,8676672,3470,3076,2,FBtr0079727,FBgn0001114,77
2L,8676851,8679782,2931,1871,4,FBtr0079753,FBgn0032057,21
2L,8681406,8684350,2944,2017,5,FBtr0079751,FBgn0032058,25
2L,8685351,8685803,452,452,1,FBtr0079750,FBgn0032059,1
2L,8686318,8687031,713,655,2,FBtr0079730,FBgn0260861,11
2L,8687781,8704457,16676,2105,7,FBtr0079747,FBgn0004914,43
2L,8705695,8707275,1580,1516,2,FBtr0079731,FBgn0032061,10
2L,8710438,8740413,29975,2406,9,FBtr0079745,FBgn0003209,26
2L,8751890,8751967,77,77,1,FBtr0345576,FBgn0266845,5
2L,8752400,8753122,722,722,1,FBtr0079732,FBgn0032065,12
2L,8765421,8768669,3248,3004,5,FBtr0079744,FBgn0032066,79
2L,8769178,8772344,3166,2929,5,FBtr0302992,FBgn0032067,89
2L,8773007,8776196,3189,2941,5,FBtr0079742,FBgn0032068,26
2L,8777734,8781186,3452,3016,5,FBtr0079741,FBgn0032069,43
2L,8781900,8782403,503,503,1,FBtr0302991,FBgn0261627,5
2L,8826494,8828209,1715,1715,1,FBtr0079733,FBgn0029123,52
2L,8862807,8863676,869,869,1,FBtr0079734,FBgn0052986,24
2L,8863855,8864625,770,770,1,FBtr0079735,FBgn0052987,12
2L,8864904,8865668,764,764,1,FBtr0079736,FBgn0052988,10
2L,8865907,8866656,749,749,1,FBtr0079737,FBgn0052983,13
2L,8866867,8867592,725,725,1,FBtr0079738,FBgn0032072,13
2L,8891507,8891849,342,274,2,FBtr0302995,FBgn0261630,5
2L,8915835,8931935,16100,5780,10,FBtr0112648,FBgn0085427,154
2L,8934990,8935954,964,741,3,FBtr0079754,FBgn0032074,18
2L,8937551,8939598,2047,920,4,FBtr0079755,FBgn0032075,8
2L,8939919,8941724,1805,1404,3,FBtr0100481,FBgn0032076,28
2L,8942308,8943218,910,623,4,FBtr0079791,FBgn0032077,11
2L,8943937,8945400,1463,1161,3,FBtr0079788,FBgn0032078,13
2L,8954025,8955575,1550,1550,1,FBtr0079787,FBgn0032079,23
2L,8960321,8962354,2033,2033,1,FBtr0079786,FBgn0032080,92
2L,8962617,8964596,1979,1851,3,FBtr0079757,FBgn0052985,41
2L,8965134,8967025,1891,1770,3,FBtr0079758,FBgn0052984,48
2L,8967570,8970023,2453,1986,3,FBtr0079759,FBgn0032082,42
2L,8970804,8974931,4127,1839,9,FBtr0332206,FBgn0032083,36
2L,8978045,8980158,2113,949,5,FBtr0079783,FBgn0032084,19
2L,8980732,8981297,565,435,3,FBtr0079760,FBgn0040963,6
2L,8986344,8989037,2693,821,4,FBtr0079782,FBgn0011705,4
2L,8992063,8993307,1244,821,4,FBtr0079761,FBgn0032085,8
2L,8994463,8995543,1080,821,4,FBtr0079762,FBgn0032086,23
2L,8995605,8997263,1658,1326,6,FBtr0079780,FBgn0013746,5
2L,8997664,8998383,719,664,2,FBtr0079763,FBgn0040964,29
2L,8998611,8999411,800,800,1,FBtr0301665,FBgn0015316,12
2L,9010660,9011241,581,447,3,FBtr0079765,FBgn0032087,6
2L,9012264,9012840,576,447,3,FBtr0079766,FBgn0032088,5
2L,9013053,9013922,869,869,1,FBtr0079779,FBgn0032089,8
2L,9024467,9025366,899,899,1,FBtr0079778,FBgn0032090,14
2L,9052905,9066401,13496,1587,9,FBtr0079776,FBgn0051708,24
2L,9077242,9077934,692,692,1,FBtr0079767,FBgn0032094,29
2L,9084107,9089437,5330,3371,4,FBtr0079768,FBgn0032095,98
2L,9097627,9098053,426,367,2,FBtr0299873,FBgn0051609,8
2L,9111814,9113282,1468,1124,7,FBtr0079770,FBgn0032096,16
2L,9127023,9163446,36423,2137,8,FBtr0079771,FBgn0052982,59
2L,9151414,9163160,11746,1643,7,FBtr0110960,FBgn0052982,29
2L,9164348,9165217,869,697,2,FBtr0079773,FBgn0032100,26
2L,9165603,9166384,781,621,3,FBtr0079774,FBgn0032101,16
2L,9191785,9245805,54020,6065,13,FBtr0303870,FBgn0041092,195
2L,9250295,9251008,713,646,2,FBtr0079819,FBgn0032104,20
2L,9251681,9252986,1305,942,3,FBtr0079817,FBgn0032105,18
2L,9254163,9254831,668,668,1,FBtr0079816,FBgn0040097,9
2L,9272495,9291158,18663,214,2,FBtr0079795,FBgn0267252,0
2L,9327800,9330030,2230,1818,6,FBtr0273186,FBgn0032109,19
2L,9331055,9331348,293,220,2,FBtr0079799,FBgn0010314,4
2L,9338155,9340759,2604,1427,10,FBtr0079800,FBgn0026439,24
2L,9342995,9344320,1325,1325,1,FBtr0079803,FBgn0032110,47
2L,9349557,9349872,315,256,2,FBtr0307098,FBgn0263082,12
2L,9350548,9350946,398,398,1,FBtr0079805,FBgn0032111,2
2L,9367706,9368314,608,608,1,FBtr0112374,FBgn0085210,15
2L,9373028,9405875,32847,2800,11,FBtr0308029,FBgn0085395,107
2L,9387768,9391436,3668,1556,4,FBtr0079806,FBgn0012036,16
2L,9397180,9397746,566,566,1,FBtr0079813,FBgn0032115,11
2L,9420671,9426097,5426,2873,4,FBtr0079807,FBgn0032116,42
2L,9426935,9427762,827,766,2,FBtr0079808,FBgn0000640,16
2L,9428023,9428499,476,421,2,FBtr0303932,FBgn0262036,15
2L,9428833,9430930,2097,1328,4,FBtr0079811,FBgn0032117,24
2L,9431714,9434912,3198,2818,2,FBtr0079809,FBgn0011232,45
2L,9435510,9436724,1214,1102,2,FBtr0079810,FBgn0032119,27
2L,9436953,9437180,227,227,1,FBtr0112375,FBgn0085211,9
2L,9440014,9440740,726,536,4,FBtr0091721,FBgn0053723,18
2L,9460288,9462275,1987,1665,3,FBtr0079822,FBgn0002973,46
2L,9492087,9494615,2528,1326,3,FBtr0079862,FBgn0004868,17
2L,9503792,9519765,15973,4537,14,FBtr0089853,FBgn0032120,68
2L,9528528,9529511,983,983,1,FBtr0079829,FBgn0032122,42
2L,9533582,9538651,5069,3584,7,FBtr0079825,FBgn0032123,60
2L,9540644,9541744,1100,871,5,FBtr0079830,FBgn0032124,16
2L,9542947,9543475,528,457,2,FBtr0079831,FBgn0032125,4
2L,9544175,9544789,614,614,1,FBtr0079832,FBgn0032126,19
2L,9546017,9547294,1277,1277,1,FBtr0273329,FBgn0032127,25
2L,9549582,9555938,6356,3154,8,FBtr0079860,FBgn0032129,77
2L,9571509,9572962,1453,1302,3,FBtr0079834,FBgn0032130,32
2L,9573773,9576188,2415,2228,4,FBtr0079857,FBgn0028479,40
2L,9578817,9579564,747,621,3,FBtr0079856,FBgn0051709,30
2L,9580006,9581592,1586,1510,2,FBtr0079855,FBgn0014179,32
2L,9589666,9591544,1878,1689,3,FBtr0079836,FBgn0032131,44
2L,9598943,9600853,1910,1736,4,FBtr0114535,FBgn0032132,18
2L,9608898,9612532,3634,1814,4,FBtr0079837,FBgn0019809,50
2L,9613517,9615678,2161,315,3,FBtr0079839,FBgn0040070,7
2L,9616480,9622424,5944,976,5,FBtr0079841,FBgn0032135,15
2L,9624861,9625223,362,362,1,FBtr0079853,FBgn0051882,30
2L,9641746,9655910,14164,12980,19,FBtr0303874,FBgn0032136,147
2L,9656645,9657223,578,578,1,FBtr0300213,FBgn0053299,9
2L,9696508,9697566,1058,1058,1,FBtr0079851,FBgn0000273,13
2L,9699935,9700377,442,379,2,FBtr0079846,FBgn0015393,12
2L,9701053,9708266,7213,1180,5,FBtr0079847,FBgn0011207,28
2L,9703085,9703539,454,364,2,FBtr0079849,FBgn0051710,10
2L,9709030,9711137,2107,1877,4,FBtr0079848,FBgn0032138,23
2L,9717526,9743284,25758,2561,7,FBtr0079926,FBgn0028704,62
2L,9730004,9730630,626,626,1,FBtr0079863,FBgn0032139,7
2L,9736710,9737039,329,329,1,FBtr0079864,FBgn0032140,11
2L,9748015,9750020,2005,1572,6,FBtr0079925,FBgn0015035,47
2L,9758750,9762138,3388,2327,4,FBtr0079865,FBgn0270924,21
2L,9762525,9763174,649,586,2,FBtr0079924,FBgn0011291,9
2L,9763629,9765194,1565,1341,3,FBtr0079866,FBgn0283478,18
2L,9765360,9770996,5636,1651,8,FBtr0335505,FBgn0265001,45
2L,9767072,9768397,1325,1270,2,FBtr0079867,FBgn0032143,26
2L,9769084,9770373,1289,1289,1,FBtr0079868,FBgn0032144,22
2L,9771158,9773042,1884,1587,6,FBtr0100832,FBgn0065108,16
2L,9773111,9775030,1919,1544,4,FBtr0100831,FBgn0065109,83
2L,9782785,9788168,5383,1319,4,FBtr0079869,FBgn0032147,32
2L,9790970,9791941,971,910,2,FBtr0079870,FBgn0032149,12
2L,9791985,9793006,1021,967,2,FBtr0079917,FBgn0032150,22
2L,9797111,9869598,72487,1556,13,FBtr0079912,FBgn0032151,20
2L,9888143,9889987,1844,1309,8,FBtr0079872,FBgn0029174,14
2L,9890133,9890740,607,425,4,FBtr0112376,FBgn0085212,13
2L,9890910,9891259,349,289,2,FBtr0113031,FBgn0032153,3
2L,9891354,9893419,2065,1836,3,FBtr0079911,FBgn0032154,38
2L,9895378,9896037,659,598,2,FBtr0079874,FBgn0010520,10
2L,9896330,9897130,800,800,1,FBtr0079905,FBgn0004867,13
2L,9897956,9903117,5161,5104,2,FBtr0305657,FBgn0053300,83
2L,9903720,9906173,2453,1523,7,FBtr0079902,FBgn0032156,15
2L,9909242,9912476,3234,2524,8,FBtr0079901,FBgn0032157,23
2L,9913048,9914586,1538,1538,1,FBtr0079875,FBgn0024285,17
2L,9915348,9917118,1770,1190,4,FBtr0079876,FBgn0040064,15
2L,9917446,9918081,635,568,2,FBtr0079900,FBgn0025700,10
2L,9918881,9919843,962,840,3,FBtr0079877,FBgn0032160,12
2L,9920374,9921318,944,837,3,FBtr0079878,FBgn0032161,31
2L,9921741,9922724,983,858,3,FBtr0079879,FBgn0032162,16
2L,9922797,9924860,2063,1692,6,FBtr0079898,FBgn0032163,43
2L,9926613,9929946,3333,2112,6,FBtr0299965,FBgn0259712,41
2L,9930626,9930996,370,307,2,FBtr0331634,FBgn0259713,8
2L,9932590,9933092,502,436,2,FBtr0079897,FBgn0051876,22
2L,9935259,9938005,2746,866,4,FBtr0079896,FBgn0051712,13
2L,9938255,9938738,483,424,2,FBtr0079895,FBgn0051713,2
2L,9938964,9940733,1769,1708,2,FBtr0079883,FBgn0032166,24
2L,9940920,9944655,3735,2058,9,FBtr0079894,FBgn0032167,34
2L,9952584,9954093,1509,1386,3,FBtr0079892,FBgn0032168,17
2L,9954514,9956173,1659,1536,3,FBtr0079884,FBgn0032169,20
2L,9956292,9956993,701,701,1,FBtr0079891,FBgn0032171,12
2L,9957589,9959717,2128,1574,4,FBtr0079885,FBgn0032170,27
2L,9961007,9963392,2385,1818,6,FBtr0329986,FBgn0032172,37
2L,9964548,9966885,2337,2123,4,FBtr0079889,FBgn0015664,18
2L,9967635,9968418,783,651,3,FBtr0079888,FBgn0011272,11
2L,9984950,9994655,9705,2083,5,FBtr0079929,FBgn0000180,27
2L,9996009,9996491,482,482,1,FBtr0079973,FBgn0051875,8
2L,9996935,10001428,4493,4426,2,FBtr0303882,FBgn0051755,173
2L,10004047,10007763,3716,1797,9,FBtr0079930,FBgn0043456,20
2L,10009501,10012490,2989,1241,4,FBtr0079931,FBgn0011584,6
2L,10013274,10017331,4057,3948,3,FBtr0079971,FBgn0032175,173
2L,10026762,10028963,2201,2201,1,FBtr0079933,FBgn0032176,82
2L,10032893,10038870,5977,1006,5,FBtr0079934,FBgn0027600,22
2L,10049616,10050895,1279,1219,2,FBtr0079935,FBgn0053301,36
2L,10054356,10055869,1513,1018,2,FBtr0079936,FBgn0053302,47
2L,10057697,10059464,1767,1562,4,FBtr0079937,FBgn0267727,19
2L,10062572,10063834,1262,1143,3,FBtr0079938,FBgn0032178,42
2L,10064801,10137355,72554,5819,19,FBtr0335509,FBgn0265002,206
2L,10091585,10092235,650,650,1,FBtr0079969,FBgn0032181,13
2L,10101188,10125628,24440,2388,12,FBtr0300423,FBgn0083945,64
2L,10122344,10122739,395,395,1,FBtr0079966,FBgn0032184,20
2L,10147085,10155213,8128,2999,10,FBtr0079943,FBgn0032187,84
2L,10172734,10174053,1319,1319,1,FBtr0301684,FBgn0032188,37
2L,10182787,10198623,15836,6646,23,FBtr0452144,FBgn0028675,132
2L,10189919,10191424,1505,1450,2,FBtr0079964,FBgn0051874,16
2L,10199835,10200538,703,588,3,FBtr0079962,FBgn0032189,5
2L,10201230,10202055,825,754,2,FBtr0079946,FBgn0005593,6
2L,10202886,10204188,1302,438,3,FBtr0112350,FBgn0085188,15
2L,10205372,10206841,1469,1469,1,FBtr0079960,FBgn0032191,41
2L,10207314,10208796,1482,1234,5,FBtr0079959,FBgn0032192,11
2L,10209998,10210603,605,547,2,FBtr0079958,FBgn0032193,2
2L,10211422,10213694,2272,2078,4,FBtr0079947,FBgn0032194,11
2L,10213976,10218871,4895,3850,11,FBtr0079957,FBgn0024320,42
2L,10221443,10222405,962,834,3,FBtr0079948,FBgn0250843,11
2L,10223146,10224438,1292,1292,1,FBtr0079949,FBgn0032195,12
2L,10224763,10225750,987,719,4,FBtr0079955,FBgn0032196,2
2L,10227864,10229950,2086,1865,4,FBtr0079953,FBgn0032197,14
2L,10232573,10234356,1783,685,2,FBtr0079951,FBgn0032198,11
2L,10234790,10237845,3055,2147,7,FBtr0301973,FBgn0051720,36
2L,10239536,10242045,2509,1372,5,FBtr0079975,FBgn0004419,5
2L,10242640,10246021,3381,2896,8,FBtr0080088,FBgn0024248,41
2L,10247651,10249210,1559,1110,6,FBtr0080087,FBgn0000229,7
2L,10250819,10251498,679,610,2,FBtr0079977,FBgn0051717,3
2L,10251967,10254594,2627,2047,8,FBtr0079978,FBgn0010407,11
2L,10254835,10255815,980,465,3,FBtr0080086,FBgn0032200,3
2L,10256456,10259575,3119,1245,9,FBtr0089902,FBgn0026379,6
2L,10262819,10263418,599,599,1,FBtr0080079,FBgn0011305,30
2L,10264208,10264960,752,278,4,FBtr0089735,FBgn0032202,4
2L,10265520,10266502,982,654,6,FBtr0079983,FBgn0259482,2
2L,10266810,10268423,1613,1309,5,FBtr0079984,FBgn0032204,11
2L,10268961,10269870,909,734,4,FBtr0079985,FBgn0032205,3
2L,10270115,10271453,1338,1221,3,FBtr0079986,FBgn0260750,16
2L,10271505,10272209,704,704,1,FBtr0080078,FBgn0003751,7
2L,10272715,10278698,5983,3393,15,FBtr0080075,FBgn0260749,44
2L,10279122,10280830,1708,1008,6,FBtr0300408,FBgn0054043,33
2L,10282000,10290490,8490,8175,6,FBtr0080074,FBgn0032208,72
2L,10292784,10295299,2515,518,4,FBtr0080073,FBgn0032209,3
2L,10295920,10299204,3284,1907,10,FBtr0080070,FBgn0032210,16
2L,10300225,10301955,1730,1645,2,FBtr0080066,FBgn0032211,37
2L,10302674,10303836,1162,1105,2,FBtr0080065,FBgn0005322,18
2L,10304165,10305505,1340,1215,3,FBtr0080064,FBgn0032213,11
2L,10307045,10307968,923,783,3,FBtr0079987,FBgn0032214,4
2L,10308337,10310304,1967,1412,4,FBtr0080063,FBgn0027491,13
2L,10311333,10312058,725,610,2,FBtr0080062,FBgn0267365,8
2L,10312387,10314311,1924,1418,7,FBtr0080061,FBgn0032216,4
2L,10314914,10317294,2380,1677,6,FBtr0079988,FBgn0032217,28
2L,10317592,10320019,2427,2052,6,FBtr0080060,FBgn0032218,54
2L,10322793,10324962,2169,1193,4,FBtr0079989,FBgn0032219,29
2L,10325102,10327878,2776,2432,4,FBtr0080059,FBgn0011703,19
2L,10328350,10330564,2214,1841,7,FBtr0113033,FBgn0032221,24
2L,10331610,10332968,1358,1169,4,FBtr0079992,FBgn0032222,31
2L,10334075,10338405,4330,2518,8,FBtr0079993,FBgn0032223,18
2L,10339515,10341378,1863,1034,7,FBtr0079994,FBgn0019932,7
2L,10341682,10342372,690,359,4,FBtr0079996,FBgn0051715,2
2L,10342759,10344038,1279,1106,4,FBtr0079998,FBgn0032224,12
2L,10344654,10347548,2894,1708,8,FBtr0079999,FBgn0032225,22
2L,10348020,10353631,5611,1255,5,FBtr0112592,FBgn0085396,40
2L,10348184,10352056,3872,666,3,FBtr0333005,FBgn0085396,34
2L,10354813,10356276,1463,1009,5,FBtr0080055,FBgn0032228,21
2L,10356915,10357782,867,756,3,FBtr0080000,FBgn0032229,12
2L,10358310,10362507,4197,3736,8,FBtr0080054,FBgn0027568,48
2L,10363099,10363821,722,594,3,FBtr0080001,FBgn0003087,17
2L,10365118,10366146,1028,800,4,FBtr0080002,FBgn0032230,3
2L,10366876,10367736,860,860,1,FBtr0080003,FBgn0032231,19
2L,10368179,10372898,4719,4281,6,FBtr0089855,FBgn0041723,96
2L,10374304,10375733,1429,1372,2,FBtr0080052,FBgn0053303,21
2L,10377322,10379167,1845,1149,6,FBtr0080004,FBgn0032233,20
2L,10380149,10381778,1629,1421,4,FBtr0080005,FBgn0032234,36
2L,10382340,10384624,2284,1467,6,FBtr0080006,FBgn0032235,20
2L,10384845,10386177,1332,888,3,FBtr0080051,FBgn0004106,4
2L,10386744,10387471,727,652,2,FBtr0080007,FBgn0032236,4
2L,10390062,10392191,2129,2129,1,FBtr0080008,FBgn0267821,62
2L,10393937,10396217,2280,1009,2,FBtr0080050,FBgn0262782,22
2L,10398115,10402767,4652,3137,16,FBtr0080009,FBgn0051716,58
2L,10403239,10403995,756,458,4,FBtr0100253,FBgn0032240,6
2L,10404388,10405136,748,612,3,FBtr0091657,FBgn0067622,5
2L,10405752,10408125,2373,1938,6,FBtr0336967,FBgn0051718,26
2L,10408767,10409543,776,776,1,FBtr0080017,FBgn0025366,5
2L,10409731,10410387,656,466,2,FBtr0080016,FBgn0003942,5
2L,10410640,10413430,2790,2259,9,FBtr0080047,FBgn0032242,17
2L,10414602,10418422,3820,3133,11,FBtr0080018,FBgn0032243,27
2L,10419265,10420549,1284,990,6,FBtr0080019,FBgn0032244,8
2L,10420831,10422643,1812,1744,2,FBtr0080046,FBgn0005683,52
2L,10423520,10425269,1749,1218,6,FBtr0080020,FBgn0032246,10
2L,10425531,10426496,965,595,2,FBtr0304118,FBgn0262601,21
2L,10427171,10427806,635,635,1,FBtr0080021,FBgn0267330,9
2L,10428848,10429908,1060,948,3,FBtr0080024,FBgn0032247,14
2L,10430062,10430714,652,595,2,FBtr0080044,FBgn0032248,3
2L,10431403,10432522,1119,941,4,FBtr0080025,FBgn0004915,10
2L,10433158,10435337,2179,2104,2,FBtr0080043,FBgn0032249,30
2L,10436086,10437166,1080,954,3,FBtr0080026,FBgn0032250,7
2L,10437839,10439121,1282,861,6,FBtr0080027,FBgn0027052,2
2L,10439529,10440623,1094,865,5,FBtr0273339,FBgn0032251,15
2L,10444760,10449709,4949,2630,10,FBtr0080029,FBgn0032252,51
2L,10450137,10452201,2064,1444,11,FBtr0100097,FBgn0065110,19
2L,10452713,10455822,3109,2845,5,FBtr0080042,FBgn0032253,60
2L,10457852,10462407,4555,3230,10,FBtr0080030,FBgn0027611,43
2L,10463814,10472171,8357,2207,10,FBtr0080039,FBgn0051719,36
2L,10477386,10482916,5530,1632,9,FBtr0080032,FBgn0032256,28
2L,10483358,10485729,2371,1942,8,FBtr0080033,FBgn0026431,23
2L,10485751,10488497,2746,2320,8,FBtr0080038,FBgn0032258,25
2L,10488959,10489705,746,682,2,FBtr0100565,FBgn0032259,14
2L,10490492,10491364,872,872,1,FBtr0080037,FBgn0032260,13
2L,10492334,10506014,13680,3024,9,FBtr0080035,FBgn0086347,36
2L,10507194,10507865,671,607,2,FBtr0080091,FBgn0032261,21
2L,10508090,10510238,2148,1811,4,FBtr0080135,FBgn0032262,41
2L,10511670,10516592,4922,1874,4,FBtr0347403,FBgn0267828,23
2L,10517426,10518770,1344,1282,2,FBtr0080092,FBgn0010398,30
2L,10527790,10531404,3614,1339,5,FBtr0331672,FBgn0032264,26
2L,10531852,10533573,1721,1262,4,FBtr0080094,FBgn0032265,31
2L,10534973,10536312,1339,1215,3,FBtr0080095,FBgn0032266,23
2L,10545404,10626979,81575,2178,9,FBtr0080096,FBgn0051721,39
2L,10567383,10567937,554,554,1,FBtr0080098,FBgn0032268,14
2L,10576431,10577717,1286,1225,2,FBtr0080132,FBgn0032269,41
2L,10579905,10580192,287,211,2,FBtr0112351,FBgn0250826,4
2L,10581094,10581637,543,371,4,FBtr0112352,FBgn0085190,10
2L,10629502,10630995,1493,1368,3,FBtr0080131,FBgn0032271,32
2L,10639946,10643372,3426,3215,4,FBtr0080099,FBgn0051872,69
2L,10643995,10645747,1752,1366,5,FBtr0300805,FBgn0043825,23
2L,10646435,10650041,3606,3256,5,FBtr0080101,FBgn0265264,72
2L,10652115,10654220,2105,1954,2,FBtr0080103,FBgn0032276,32
2L,10658358,10658492,134,134,1,FBtr0346470,FBgn0267254,12
2L,10662509,10671176,8667,1588,5,FBtr0080104,FBgn0051871,20
2L,10677908,10679352,1444,1345,2,FBtr0080105,FBgn0040496,60
2L,10681047,10681355,308,308,1,FBtr0080106,FBgn0032280,16
2L,10681991,10682278,287,287,1,FBtr0080107,FBgn0032281,36
2L,10683842,10684372,530,530,1,FBtr0080130,FBgn0032282,28
2L,10686465,10686947,482,482,1,FBtr0080129,FBgn0032283,53
2L,10688816,10689196,380,380,1,FBtr0080128,FBgn0032284,39
2L,10693035,10694060,1025,1025,1,FBtr0080127,FBgn0032285,39
2L,10695367,10698024,2657,2657,1,FBtr0080125,FBgn0032286,109
2L,10699591,10701363,1772,1312,5,FBtr0080124,FBgn0023496,23
2L,10702398,10706190,3792,1233,6,FBtr0080123,FBgn0024740,24
2L,10703634,10704904,1270,1213,2,FBtr0080108,FBgn0032287,45
2L,10724274,10728673,4399,1047,6,FBtr0303568,FBgn0032289,8
2L,10729240,10730199,959,895,2,FBtr0080110,FBgn0032290,18
2L,10730299,10731264,965,840,3,FBtr0080111,FBgn0032291,10
2L,10731534,10732334,800,739,2,FBtr0080122,FBgn0032292,11
2L,10732818,10733219,401,401,1,FBtr0080112,FBgn0032293,22
2L,10733347,10735945,2598,2533,2,FBtr0080121,FBgn0027868,60
2L,10736379,10736957,578,578,1,FBtr0080120,FBgn0032294,7
2L,10737888,10740095,2207,2207,1,FBtr0080113,FBgn0032295,51
2L,10740882,10743874,2992,2828,4,FBtr0080119,FBgn0032296,51
2L,10745491,10745997,506,369,3,FBtr0080117,FBgn0032297,7
2L,10761506,10764805,3299,2019,6,FBtr0080114,FBgn0027550,70
2L,10766121,10766991,870,693,3,FBtr0080115,FBgn0015320,20
2L,10768290,10769733,1443,1256,4,FBtr0080191,FBgn0032298,24
2L,10770985,10771278,293,293,1,FBtr0080136,FBgn0032299,2
2L,10773038,10788970,15932,2325,6,FBtr0080189,FBgn0051869,71
2L,10790352,10790647,295,235,2,FBtr0080137,FBgn0051870,1
2L,10804522,10831927,27405,4029,18,FBtr0080188,FBgn0011676,66
2L,10819123,10820391,1268,1268,1,FBtr0080139,FBgn0032303,40
2L,10820733,10821905,1172,1172,1,FBtr0080140,FBgn0032304,23
2L,10839319,10842188,2869,2617,5,FBtr0080187,FBgn0032305,36
2L,10843084,10844292,1208,1080,3,FBtr0100837,FBgn0260453,14
2L,10844453,10845599,1146,1017,3,FBtr0100836,FBgn0260454,25
2L,10845891,10846898,1007,876,3,FBtr0080184,FBgn0069354,11
2L,10847871,10848863,992,843,3,FBtr0080182,FBgn0004363,4
2L,10851332,10854429,3097,1505,4,FBtr0305257,FBgn0262599,26
2L,10855190,10856278,1088,825,3,FBtr0080181,FBgn0027453,12
2L,10856876,10857977,1101,984,3,FBtr0080180,FBgn0024227,12
2L,10858835,10861518,2683,2063,4,FBtr0080143,FBgn0027363,59
2L,10870240,10870653,413,413,1,FBtr0080144,FBgn0032311,14
2L,10888371,10888778,407,407,1,FBtr0080178,FBgn0032312,7
2L,10900887,10901695,808,751,2,FBtr0080177,FBgn0032313,9
2L,10906698,10908812,2114,1575,9,FBtr0301184,FBgn0032314,9
2L,10910233,10910535,302,302,1,FBtr0080175,FBgn0032315,8
2L,10917753,10961224,43471,1223,7,FBtr0340553,FBgn0261871,19
2L,10937385,10937805,420,361,2,FBtr0080145,FBgn0032318,9
2L,10965608,10970122,4514,2023,8,FBtr0080169,FBgn0053129,33
2L,10970554,10971801,1247,1049,4,FBtr0080146,FBgn0032321,15
2L,10972508,10973227,719,719,1,FBtr0329948,FBgn0032322,17
2L,10973539,10975212,1673,1615,2,FBtr0080168,FBgn0000018,29
2L,10975905,10976290,385,295,2,FBtr0080167,FBgn0010612,4
2L,10977962,10981662,3700,1835,4,FBtr0080148,FBgn0041781,21
2L,10982661,10987332,4671,2521,8,FBtr0080166,FBgn0004872,31
2L,10987835,10989164,1329,1131,3,FBtr0080149,FBgn0026148,10
2L,10990185,10997397,7212,3204,9,FBtr0300400,FBgn0026147,32
2L,10997935,11001365,3430,2589,9,FBtr0080165,FBgn0000146,26
2L,11002083,11002668,585,529,2,FBtr0113317,FBgn0040096,14
2L,11002910,11003751,841,568,2,FBtr0080163,FBgn0015756,2
2L,11004980,11009756,4776,4083,12,FBtr0089881,FBgn0021761,40
2L,11009914,11010992,1078,1021,2,FBtr0080162,FBgn0032329,7
2L,11011441,11012004,563,563,1,FBtr0080157,FBgn0250837,8
2L,11014203,11055377,41174,2898,6,FBtr0080161,FBgn0032330,119
2L,11015645,11016400,755,755,1,FBtr0080158,FBgn0023415,23
2L,11017172,11018736,1564,1495,2,FBtr0113035,FBgn0032331,33
2L,11034852,11035232,380,380,1,FBtr0080160,FBgn0040967,4
2L,11071061,11071420,359,359,1,FBtr0080193,FBgn0032335,5
2L,11075548,11075739,191,191,1,FBtr0329904,FBgn0263971,1
2L,11076738,11077221,483,363,3,FBtr0080234,FBgn0032336,2
2L,11083790,11085170,1380,758,4,FBtr0114455,FBgn0032337,21
2L,11087097,11090416,3319,2113,2,FBtr0304586,FBgn0032338,30
2L,11091567,11094834,3267,2901,6,FBtr0080196,FBgn0032339,34
2L,11095691,11100559,4868,4052,10,FBtr0080231,FBgn0283682,40
2L,11102630,11106213,3583,2714,7,FBtr0080230,FBgn0032341,71
2L,11107065,11110432,3367,2442,6,FBtr0080197,FBgn0261983,45
2L,11110845,11112949,2104,1904,4,FBtr0080229,FBgn0032343,29
2L,11114183,11115752,1569,1379,4,FBtr0080198,FBgn0041246,18
2L,11116139,11120171,4032,3668,7,FBtr0080228,FBgn0027582,49
2L,11120746,11121585,839,718,2,FBtr0080227,FBgn0032345,19
2L,11122805,11123470,665,610,2,FBtr0080226,FBgn0032346,2
2L,11123879,11128923,5044,4219,14,FBtr0080199,FBgn0262647,41
2L,11128994,11130171,1177,1066,2,FBtr0080225,FBgn0028700,14
2L,11130865,11135484,4619,4230,6,FBtr0080200,FBgn0032348,74
2L,11136433,11138477,2044,1309,8,FBtr0080201,FBgn0040211,14
2L,11138804,11148875,10071,3550,23,FBtr0112856,FBgn0010197,41
2L,11144732,11145355,623,623,1,FBtr0080224,FBgn0051867,19
2L,11151674,11155601,3927,990,6,FBtr0080222,FBgn0032350,28
2L,11159273,11170439,11166,2441,10,FBtr0300115,FBgn0259822,45
2L,11171287,11171634,347,347,1,FBtr0080216,FBgn0014076,10
2L,11179232,11179987,755,755,1,FBtr0080202,FBgn0032354,8
2L,11235597,11259407,23810,2676,6,FBtr0332557,FBgn0264442,77
2L,11261311,11268846,7535,6555,12,FBtr0332202,FBgn0040232,78
2L,11269904,11277332,7428,5783,10,FBtr0091678,FBgn0040233,106
2L,11278113,11279460,1347,813,3,FBtr0091680,FBgn0052831,14
2L,11280372,11281667,1295,859,5,FBtr0080212,FBgn0032358,11
2L,11282180,11284272,2092,1855,5,FBtr0080213,FBgn0020270,22
2L,11284589,11285603,1014,844,2,FBtr0080214,FBgn0283678,26
2L,11342482,11343168,686,518,4,FBtr0080251,FBgn0032360,12
2L,11366413,11373206,6793,3795,6,FBtr0080235,FBgn0000287,94
2L,11435898,11445178,9280,4091,4,FBtr0089913,FBgn0261648,102
2L,11485215,11485724,509,509,1,FBtr0307103,FBgn0263087,47
2L,11486210,11486705,495,424,2,FBtr0080237,FBgn0003313,10
2L,11496904,11498882,1978,1705,5,FBtr0080248,FBgn0032361,35
2L,11502123,11507894,5771,1788,3,FBtr0305261,FBgn0032362,44
2L,11509303,11515780,6477,5739,9,FBtr0080246,FBgn0032363,55
2L,11517492,11519727,2235,2066,4,FBtr0080239,FBgn0032364,57
2L,11519944,11520330,386,386,1,FBtr0100456,FBgn0032365,7
2L,11520454,11521259,805,742,2,FBtr0080245,FBgn0032366,14
2L,11521810,11522379,569,569,1,FBtr0305602,FBgn0262683,25
2L,11523553,11525666,2113,2044,2,FBtr0080242,FBgn0028490,63
2L,11529552,11530994,1442,1051,2,FBtr0080241,FBgn0051706,46
2L,11531881,11533717,1836,1600,5,FBtr0302420,FBgn0085191,39
2L,11536546,11536710,164,164,1,FBtr0309073,FBgn0263386,11
2L,11585527,11586603,1076,1076,1,FBtr0080271,FBgn0028412,14
2L,11591528,11591668,140,140,1,FBtr0080270,FBgn0267327,0
2L,11610668,11611664,996,821,4,FBtr0340563,FBgn0032368,20
2L,11621819,11624500,2681,2681,1,FBtr0080252,FBgn0015400,62
2L,11645210,11648779,3569,3167,7,FBtr0080267,FBgn0032369,51
2L,11651394,11651939,545,545,1,FBtr0080266,FBgn0032370,15
2L,11652655,11653755,1100,1100,1,FBtr0080253,FBgn0032371,29
2L,11657469,11657846,377,377,1,FBtr0305896,FBgn0262786,8
2L,11663311,11663415,104,104,1,FBtr0340567,FBgn0265670,3
2L,11694880,11696069,1189,1102,2,FBtr0080254,FBgn0032372,14
2L,11741551,11744158,2607,2439,3,FBtr0080255,FBgn0032373,27
2L,11753202,11753530,328,271,2,FBtr0300308,FBgn0259960,6
2L,11753721,11754022,301,247,2,FBtr0300307,FBgn0259961,4
2L,11754142,11754479,337,277,2,FBtr0300306,FBgn0259962,6
2L,11788542,11789328,786,657,3,FBtr0300370,FBgn0032374,5
2L,11790004,11790933,929,639,6,FBtr0300384,FBgn0032375,14
2L,11791096,11792303,1207,975,3,FBtr0080265,FBgn0032376,19
2L,11792634,11794047,1413,1333,2,FBtr0080264,FBgn0032377,31
2L,11797128,11803439,6311,2629,5,FBtr0080260,FBgn0020309,56
2L,11811120,11812431,1311,1216,2,FBtr0080259,FBgn0032378,33
2L,11816561,11896562,80001,2849,7,FBtr0334135,FBgn0264815,104
2L,11827463,11829235,1772,1271,4,FBtr0080325,FBgn0000588,18
2L,11834139,11834339,200,200,1,FBtr0344123,FBgn0266363,5
2L,11834657,11834851,194,194,1,FBtr0344125,FBgn0266364,8
2L,11837259,11837408,149,149,1,FBtr0301936,FBgn0265349,3
2L,11837729,11837878,149,149,1,FBtr0300309,FBgn0259963,5
2L,11839935,11840231,296,296,1,FBtr0300310,FBgn0259964,4
2L,11840712,11840915,203,203,1,FBtr0080273,FBgn0051704,7
2L,11841961,11842197,236,236,1,FBtr0334143,FBgn0264750,5
2L,11843226,11843456,230,230,1,FBtr0080274,FBgn0040968,2
2L,11843753,11843983,230,230,1,FBtr0300437,FBgn0259989,14
2L,11847231,11849112,1881,1749,3,FBtr0080275,FBgn0032381,31
2L,11850412,11852441,2029,1687,5,FBtr0080276,FBgn0032382,38
2L,11853513,11853715,202,127,2,FBtr0303281,FBgn0261805,1
2L,11934505,11935713,1208,1132,2,FBtr0080278,FBgn0026392,48
2L,11936181,11937498,1317,1135,2,FBtr0080279,FBgn0026391,30
2L,11937969,11939199,1230,1150,2,FBtr0080280,FBgn0026390,29
2L,11944235,11946407,2172,1429,2,FBtr0080281,FBgn0005664,34
2L,11948110,11948463,353,353,1,FBtr0080282,FBgn0032385,10
2L,11981632,11984338,2706,2211,6,FBtr0310149,FBgn0032387,59
2L,11984510,11987945,3435,2903,7,FBtr0089572,FBgn0032388,30
2L,11988318,11988632,314,259,2,FBtr0112354,FBgn0085192,0
2L,11989066,11989824,758,758,1,FBtr0080316,FBgn0261266,10
2L,11990024,11990773,749,691,2,FBtr0080285,FBgn0032390,7
2L,11990973,11992471,1498,1383,3,FBtr0080286,FBgn0032391,15
2L,11992993,11993980,987,922,2,FBtr0080287,FBgn0051866,1
2L,11994069,11995317,1248,1192,2,FBtr0080315,FBgn0042127,18
2L,11995814,11996240,426,367,2,FBtr0080288,FBgn0051864,1
2L,11996904,11997891,987,922,2,FBtr0080289,FBgn0051865,7
2L,11997980,11999228,1248,1192,2,FBtr0321267,FBgn0042125,5
2L,11999725,12001168,1443,1384,2,FBtr0080290,FBgn0032393,26
2L,12001417,12002151,734,734,1,FBtr0080313,FBgn0032394,8
2L,12008449,12009702,1253,1143,3,FBtr0080291,FBgn0014019,14
2L,12014696,12020741,6045,5855,4,FBtr0080312,FBgn0032395,93
2L,12027782,12033528,5746,1483,5,FBtr0080292,FBgn0010497,14
2L,12034225,12035982,1757,1617,3,FBtr0289986,FBgn0042126,43
2L,12036274,12038130,1856,1765,2,FBtr0080309,FBgn0032397,34
2L,12038830,12040581,1751,1571,4,FBtr0080308,FBgn0032398,12
2L,12041112,12042991,1879,1710,3,FBtr0080307,FBgn0032399,37
2L,12045769,12045975,206,206,1,FBtr0080306,FBgn0032400,0
2L,12047399,12048861,1462,1405,2,FBtr0080305,FBgn0032401,20
2L,12050096,12051687,1591,1443,3,FBtr0080294,FBgn0032402,26
2L,12052233,12055296,3063,1493,7,FBtr0089655,FBgn0028425,21
2L,12056422,12057325,903,768,3,FBtr0080296,FBgn0032404,1
2L,12057893,12058210,317,317,1,FBtr0112355,FBgn0085193,8
2L,12058593,12063156,4563,4015,8,FBtr0080301,FBgn0027505,68
2L,12063610,12065292,1682,949,5,FBtr0302029,FBgn0032405,13
2L,12076823,12077632,809,809,1,FBtr0080297,FBgn0032406,20
2L,12083317,12085529,2212,1837,2,FBtr0080298,FBgn0003145,46
2L,12093862,12095009,1147,871,5,FBtr0080326,FBgn0032407,30
2L,12095239,12096420,1181,1181,1,FBtr0080364,FBgn0032408,18
2L,12096586,12097669,1083,1033,2,FBtr0110911,FBgn0028707,26
2L,12097951,12100538,2587,2168,4,FBtr0080330,FBgn0032409,15
2L,12101251,12103060,1809,1753,2,FBtr0080362,FBgn0029137,32
2L,12103895,12106759,2864,2237,4,FBtr0080332,FBgn0027081,44
2L,12108176,12108799,623,623,1,FBtr0080361,FBgn0015797,5
2L,12109643,12110452,809,809,1,FBtr0080334,FBgn0263234,29
2L,12111148,12111942,794,794,1,FBtr0302854,FBgn0263235,18
2L,12125098,12129626,4528,4057,5,FBtr0080336,FBgn0032414,108
2L,12130599,12133339,2740,785,4,FBtr0080360,FBgn0032415,16
2L,12138073,12140248,2175,1420,5,FBtr0080337,FBgn0032416,17
2L,12153528,12168724,15196,2613,12,FBtr0301019,FBgn0051760,52
2L,12162007,12162492,485,485,1,FBtr0302986,FBgn0051861,6
2L,12164319,12166628,2309,2101,2,FBtr0302984,FBgn0051860,70
2L,12170657,12171193,536,478,2,FBtr0080341,FBgn0032419,10
2L,12171701,12172474,773,459,3,FBtr0080358,FBgn0032420,8
2L,12173070,12173600,530,451,2,FBtr0080342,FBgn0032421,10
2L,12175568,12177598,2030,426,3,FBtr0273342,FBgn0032422,18
2L,12208216,12209907,1691,1691,1,FBtr0290239,FBgn0051759,43
2L,12241080,12310947,69867,2421,9,FBtr0080344,FBgn0000114,68
2L,12338870,12339415,545,545,1,FBtr0080350,FBgn0051862,16
2L,12343767,12343877,110,110,1,FBtr0332235,FBgn0264361,6
2L,12351996,12396561,44565,2670,9,FBtr0304856,FBgn0262475,118
2L,12356537,12357876,1339,1285,2,FBtr0080354,FBgn0032424,38
2L,12398383,12401633,3250,2763,9,FBtr0080365,FBgn0041195,60
2L,12403584,12421704,18120,1288,5,FBtr0080389,FBgn0043841,43
2L,12424938,12426333,1395,1180,5,FBtr0080366,FBgn0032428,36
2L,12427229,12427567,338,256,2,FBtr0080388,FBgn0032429,2
2L,12428057,12429969,1912,1730,4,FBtr0080367,FBgn0032430,45
2L,12430075,12430787,712,573,3,FBtr0080387,FBgn0032431,15
2L,12432348,12432683,335,335,1,FBtr0089898,FBgn0265298,17
2L,12434997,12439561,4564,1850,7,FBtr0080369,FBgn0020443,46
2L,12441792,12444388,2596,2229,6,FBtr0080384,FBgn0032433,53
2L,12446406,12448113,1707,1273,5,FBtr0080383,FBgn0032434,25
2L,12448662,12451924,3262,2437,5,FBtr0080370,FBgn0032435,36
2L,12452064,12453230,1166,1063,2,FBtr0080382,FBgn0032436,42
2L,12457759,12491849,34090,675,3,FBtr0299652,FBgn0259176,31
2L,12496648,12497295,647,647,1,FBtr0080381,FBgn0051858,31
2L,12593998,12627082,33084,2879,4,FBtr0112642,FBgn0085424,97
2L,12610722,12611381,659,659,1,FBtr0080376,FBgn0032439,13
2L,12660466,12685822,25356,2675,4,FBtr0080392,FBgn0004394,77
2L,12667268,12669274,2006,2006,1,FBtr0080412,FBgn0032442,47
2L,12690541,12692822,2281,1594,5,FBtr0080411,FBgn0032444,12
2L,12693083,12693841,758,630,3,FBtr0080394,FBgn0032445,14
2L,12693990,12694912,922,682,5,FBtr0300273,FBgn0032446,16
2L,12695116,12698818,3702,1509,3,FBtr0080395,FBgn0032447,34
2L,12696474,12697271,797,797,1,FBtr0080409,FBgn0032448,13
2L,12699155,12700514,1359,1294,2,FBtr0080408,FBgn0032449,30
2L,12701893,12704400,2507,2394,3,FBtr0080407,FBgn0032450,73
2L,12704792,12706444,1652,1153,2,FBtr0080397,FBgn0032451,10
2L,12706912,12707529,617,617,1,FBtr0080406,FBgn0032452,17
2L,12707771,12708541,770,770,1,FBtr0080398,FBgn0032453,15
2L,12709256,12712306,3050,2847,3,FBtr0080405,FBgn0032454,82
2L,12713343,12721721,8378,1000,5,FBtr0089908,FBgn0032455,21
2L,12722431,12744168,21737,4635,12,FBtr0090013,FBgn0032456,53
2L,12760459,12761792,1333,1219,2,FBtr0080402,FBgn0032457,31
2L,12819021,12821660,2639,2639,1,FBtr0332210,FBgn0015399,64
2L,12912589,12916718,4129,3378,12,FBtr0080413,FBgn0040508,17
2L,12916916,12920895,3979,3330,12,FBtr0080414,FBgn0040509,21
2L,12921114,12925258,4144,3324,12,FBtr0080415,FBgn0040510,36
2L,12925619,12929752,4133,3357,12,FBtr0310556,FBgn0040506,34
2L,12966749,12967785,1036,844,2,FBtr0273445,FBgn0032462,14
2L,12975637,12978066,2429,1838,4,FBtr0080418,FBgn0263598,24
2L,12978900,12981191,2291,2227,2,FBtr0080421,FBgn0032464,31
2L,12994078,13000541,6463,786,6,FBtr0080430,FBgn0032465,14
2L,13001415,13003659,2244,1838,4,FBtr0080429,FBgn0265262,16
2L,13004786,13012929,8143,7403,7,FBtr0080422,FBgn0021796,87
2L,13013618,13018056,4438,3643,8,FBtr0080428,FBgn0032467,64
2L,13019679,13021178,1499,1125,3,FBtr0080427,FBgn0028965,26
2L,13023326,13031333,8007,6508,5,FBtr0089956,FBgn0262160,156
2L,13106885,13109406,2521,1960,5,FBtr0301366,FBgn0032470,29
2L,13119496,13120366,870,511,5,FBtr0304630,FBgn0262352,3
2L,13130722,13134717,3995,3785,4,FBtr0080431,FBgn0032471,117
2L,13142548,13142865,317,317,1,FBtr0080496,FBgn0032472,8
2L,13143310,13143597,287,287,1,FBtr0307212,FBgn0040972,15
2L,13158879,13160115,1236,1174,2,FBtr0080432,FBgn0028410,14
2L,13160806,13163103,2297,2239,2,FBtr0080433,FBgn0032473,34
2L,13163400,13164893,1493,1317,3,FBtr0329989,FBgn0032474,23
2L,13165991,13168638,2647,2467,2,FBtr0080434,FBgn0024291,46
2L,13170455,13173870,3415,2599,5,FBtr0080491,FBgn0032475,54
2L,13176537,13176885,348,259,2,FBtr0333234,FBgn0264546,4
2L,13177251,13178810,1559,1559,1,FBtr0080435,FBgn0032476,35
2L,13179478,13183396,3918,1222,5,FBtr0080436,FBgn0032477,18
2L,13180992,13182452,1460,1460,1,FBtr0080490,FBgn0051849,50
2L,13183589,13184784,1195,1030,2,FBtr0080437,FBgn0032478,14
2L,13185420,13189573,4153,3767,4,FBtr0080489,FBgn0032479,65
2L,13192943,13196268,3325,2396,7,FBtr0080438,FBgn0032480,21
2L,13197559,13203000,5441,5125,5,FBtr0080488,FBgn0032481,96
2L,13204190,13210225,6035,1172,7,FBtr0080439,FBgn0032482,7
2L,13210855,13211781,926,926,1,FBtr0080487,FBgn0032483,37
2L,13212660,13214671,2011,1945,2,FBtr0080485,FBgn0032484,46
2L,13217162,13219492,2330,1876,5,FBtr0080484,FBgn0032485,38
2L,13220087,13221262,1175,1175,1,FBtr0080444,FBgn0032486,20
2L,13221484,13222221,737,737,1,FBtr0080483,FBgn0032487,10
2L,13222729,13224331,1602,1361,4,FBtr0080445,FBgn0032488,22
2L,13224709,13225206,497,497,1,FBtr0080482,FBgn0032489,7
2L,13227853,13228404,551,551,1,FBtr0080446,FBgn0032490,21
2L,13229906,13230481,575,575,1,FBtr0273448,FBgn0032491,23
2L,13232108,13232974,866,866,1,FBtr0080448,FBgn0032492,22
2L,13233978,13234595,617,617,1,FBtr0080481,FBgn0032493,9
2L,13236635,13239180,2545,782,4,FBtr0080449,FBgn0027586,16
2L,13240197,13241652,1455,746,4,FBtr0080450,FBgn0032494,11
2L,13246650,13249960,3310,923,4,FBtr0080452,FBgn0032495,22
2L,13252179,13257341,5162,1912,5,FBtr0305556,FBgn0284244,60
2L,13257680,13258291,611,611,1,FBtr0080454,FBgn0051851,10
2L,13259150,13259635,485,485,1,FBtr0080480,FBgn0051730,6
2L,13261682,13283380,21698,2744,10,FBtr0334852,FBgn0264894,132
2L,13265084,13265784,700,634,2,FBtr0303784,FBgn0051848,3
2L,13267731,13276247,8516,2501,7,FBtr0334851,FBgn0264894,126
2L,13271366,13281614,10248,6731,7,FBtr0334863,FBgn0264894,242
2L,13284655,13286409,1754,1347,3,FBtr0080478,FBgn0028406,19
2L,13286940,13289287,2347,2083,5,FBtr0080460,FBgn0032499,32
2L,13290687,13301062,10375,3762,6,FBtr0080461,FBgn0051729,50
2L,13293079,13293270,191,191,1,FBtr0113336,FBgn0040973,1
2L,13304868,13310097,5229,2884,5,FBtr0331503,FBgn0264308,113
2L,13305988,13306755,767,767,1,FBtr0331506,FBgn0264301,12
2L,13306841,13307683,842,842,1,FBtr0080463,FBgn0032503,16
2L,13347797,13348819,1022,1022,1,FBtr0080464,FBgn0032505,20
2L,13350870,13354449,3579,2512,8,FBtr0302043,FBgn0032506,63
2L,13359945,13361483,1538,1063,2,FBtr0080474,FBgn0032507,41
2L,13364016,13366076,2060,2060,1,FBtr0080473,FBgn0022069,27
2L,13366531,13367305,774,645,3,FBtr0080465,FBgn0032509,4
2L,13367724,13368933,1209,1138,2,FBtr0080466,FBgn0051852,15
2L,13369401,13369727,326,326,1,FBtr0080467,FBgn0051855,3
2L,13370371,13370939,568,429,3,FBtr0080472,FBgn0032511,8
2L,13371507,13373703,2196,2082,3,FBtr0080471,FBgn0032512,29
2L,13374504,13375837,1333,1273,2,FBtr0080468,FBgn0032513,10
2L,13376716,13378357,1641,1527,3,FBtr0080470,FBgn0032514,22
2L,13379022,13382178,3156,2738,4,FBtr0080469,FBgn0025724,23
2L,13382940,13385229,2289,1254,3,FBtr0080497,FBgn0032515,27
2L,13385938,13387213,1275,850,5,FBtr0080525,FBgn0032516,5
2L,13387636,13393719,6083,5711,7,FBtr0080499,FBgn0032517,61
2L,13394416,13395060,644,462,3,FBtr0080524,FBgn0032518,9
2L,13395526,13396101,575,575,1,FBtr0080523,FBgn0032519,11
2L,13396477,13398421,1944,1879,2,FBtr0080522,FBgn0032520,16
2L,13399220,13410633,11413,2469,6,FBtr0080500,FBgn0032521,72
2L,13411229,13411585,356,356,1,FBtr0080521,FBgn0003983,8
2L,13412593,13413354,761,761,1,FBtr0080501,FBgn0032522,12
2L,13413864,13414516,652,595,2,FBtr0080520,FBgn0032523,7
2L,13420303,13420530,227,227,1,FBtr0332510,FBgn0264432,4
2L,13435749,13439261,3512,2383,2,FBtr0080502,FBgn0026760,33
2L,13444234,13445560,1326,1109,4,FBtr0080519,FBgn0032524,10
2L,13447673,13449346,1673,1673,1,FBtr0080517,FBgn0032525,36
2L,13457636,13458070,434,434,1,FBtr0303820,FBgn0261991,25
2L,13459816,13460142,326,326,1,FBtr0303821,FBgn0261992,0
2L,13475222,13499052,23830,2946,6,FBtr0308949,FBgn0263354,130
2L,13484180,13484260,80,80,1,FBtr0452123,FBgn0284224,0
2L,13504507,13513293,8786,3317,4,FBtr0080513,FBgn0023407,47
2L,13527841,13528534,693,532,2,FBtr0332506,FBgn0053640,6
2L,13529042,13529643,601,541,2,FBtr0091618,FBgn0053641,11
2L,13529975,13530595,620,559,2,FBtr0091619,FBgn0053642,8
2L,13531074,13531659,585,532,2,FBtr0091620,FBgn0053643,13
2L,13532085,13532633,548,472,2,FBtr0091621,FBgn0053644,5
2L,13532872,13533451,579,517,2,FBtr0332507,FBgn0053645,7
2L,13535401,13535721,320,320,1,FBtr0080516,FBgn0028943,7
2L,13540800,13541571,771,709,2,FBtr0080507,FBgn0028942,17
2L,13541678,13542468,790,601,2,FBtr0080515,FBgn0032530,8
2L,13542652,13543554,902,902,1,FBtr0080508,FBgn0028941,20
2L,13551603,13636646,85043,3703,11,FBtr0080509,FBgn0259984,91
2L,13595555,13596997,1442,1442,1,FBtr0080512,FBgn0028513,14
2L,13639709,13641248,1539,846,3,FBtr0080511,FBgn0028546,8
2L,13665826,13669772,3946,1537,5,FBtr0080527,FBgn0028527,46
2L,13678357,13714138,35781,2004,12,FBtr0080580,FBgn0051814,39
2L,13708515,13710445,1930,1876,2,FBtr0305567,FBgn0028848,40
2L,13722396,13723437,1041,982,2,FBtr0080579,FBgn0028847,11
2L,13736193,13736708,515,515,1,FBtr0080531,FBgn0051813,32
2L,13771241,13773480,2239,1884,6,FBtr0080532,FBgn0028541,22
2L,13774033,13774307,274,217,2,FBtr0307577,FBgn0263206,2
2L,13775003,13779732,4729,884,7,FBtr0080576,FBgn0028540,13
2L,13781000,13782094,1094,1094,1,FBtr0080534,FBgn0024846,17
2L,13782613,13783437,824,772,2,FBtr0080575,FBgn0028932,29
2L,13784170,13790298,6128,4776,15,FBtr0110941,FBgn0028539,58
2L,13791028,13793132,2104,1980,3,FBtr0110942,FBgn0028931,49
2L,13793848,13799142,5294,4956,3,FBtr0080537,FBgn0028538,40
2L,13803929,13809651,5722,807,3,FBtr0080539,FBgn0027844,22
2L,13810212,13811450,1238,1180,2,FBtr0080573,FBgn0028658,26
2L,13811645,13812631,986,737,4,FBtr0080540,FBgn0028919,5
2L,13812728,13813234,506,506,1,FBtr0080572,FBgn0032533,13
2L,13814214,13819375,5161,4781,7,FBtr0080541,FBgn0001965,86
2L,13821387,13823708,2321,1722,3,FBtr0080542,FBgn0000153,47
2L,13824143,13827691,3548,3432,3,FBtr0080571,FBgn0004406,87
2L,13828219,13829418,1199,1129,2,FBtr0080569,FBgn0001961,10
2L,13830037,13831469,1432,1378,2,FBtr0080543,FBgn0015271,18
2L,13831492,13832628,1136,1081,2,FBtr0091627,FBgn0004407,24
2L,13832628,13833071,443,443,1,FBtr0091626,FBgn0064115,17
2L,13833424,13834248,824,824,1,FBtr0080544,FBgn0026373,16
2L,13834300,13834982,682,564,3,FBtr0080566,FBgn0260407,11
2L,13836057,13897746,61689,2977,8,FBtr0080546,FBgn0028509,52
2L,13840841,13841479,638,507,3,FBtr0080565,FBgn0053307,10
2L,13842920,13843706,786,730,2,FBtr0080564,FBgn0053306,12
2L,13844419,13845262,843,778,2,FBtr0080563,FBgn0028920,11
2L,13846778,13847763,985,858,3,FBtr0080549,FBgn0028534,5
2L,13847962,13848997,1035,889,2,FBtr0080550,FBgn0028533,12
2L,13849418,13850230,812,748,2,FBtr0080551,FBgn0028532,10
2L,13899825,13903920,4095,3526,5,FBtr0080561,FBgn0019890,30
2L,13906587,13909106,2519,1839,6,FBtr0080552,FBgn0012037,27
2L,13909640,13911637,1997,1829,4,FBtr0080554,FBgn0032535,56
2L,13912201,13912560,359,359,1,FBtr0080555,FBgn0025115,7
2L,13915008,13955577,40569,2523,9,FBtr0100327,FBgn0032536,46
2L,13921766,13923360,1594,1070,4,FBtr0302990,FBgn0028938,19
2L,13930720,13931335,615,556,2,FBtr0343646,FBgn0261628,21
2L,13932999,13934609,1610,808,2,FBtr0080558,FBgn0032538,30
2L,13945232,13947100,1868,829,2,FBtr0080557,FBgn0028544,33
2L,13957850,13962135,4285,1315,5,FBtr0304719,FBgn0261514,37
2L,13963548,13965049,1501,1202,4,FBtr0080585,FBgn0027929,29
2L,13965090,13966924,1834,1260,3,FBtr0080618,FBgn0028543,35
2L,13967490,13967911,421,364,2,FBtr0100058,FBgn0054003,2
2L,13968346,13969908,1562,1341,3,FBtr0080617,FBgn0028542,32
2L,13970559,13971834,1275,942,3,FBtr0080586,FBgn0028936,24
2L,13972243,13972889,646,466,2,FBtr0080616,FBgn0028430,17
2L,13974233,13976689,2456,1858,2,FBtr0080615,FBgn0259896,44
2L,13977360,13979376,2016,1509,6,FBtr0080587,FBgn0028940,30
2L,13980210,13982637,2427,1941,3,FBtr0080588,FBgn0028939,45
2L,13983425,13993487,10062,4066,14,FBtr0080610,FBgn0003255,80
2L,14008189,14008689,500,381,3,FBtr0302892,FBgn0261582,14
2L,14015796,14019006,3210,1993,5,FBtr0080590,FBgn0027348,43
2L,14019492,14020163,671,671,1,FBtr0290243,FBgn0001967,19
2L,14027032,14029236,2204,2041,2,FBtr0080591,FBgn0028519,31
2L,14029403,14031534,2131,1688,4,FBtr0303242,FBgn0028872,30
2L,14047631,14048761,1130,1130,1,FBtr0080592,FBgn0260011,24
2L,14061611,14089257,27646,2412,12,FBtr0080594,FBgn0028875,51
2L,14104654,14159072,54418,3704,7,FBtr0445730,FBgn0283651,130
2L,14108199,14109251,1052,997,2,FBtr0080603,FBgn0028526,16
2L,14109696,14110685,989,931,2,FBtr0080602,FBgn0051769,32
2L,14161238,14163121,1883,1883,1,FBtr0306928,FBgn0263037,55
2L,14163945,14180307,16362,3492,6,FBtr0306927,FBgn0263038,54
2L,14186069,14197680,11611,2231,7,FBtr0329933,FBgn0016930,50
2L,14263721,14327748,64027,10109,16,FBtr0302731,FBgn0261563,139
2L,14277480,14277914,434,434,1,FBtr0080621,FBgn0052971,4
2L,14328469,14333772,5303,4688,10,FBtr0080623,FBgn0261529,63
2L,14334311,14345337,11026,2837,7,FBtr0080624,FBgn0028916,42
2L,14338401,14339933,1532,1532,1,FBtr0080625,FBgn0028531,23
2L,14345938,14346654,716,716,1,FBtr0080642,FBgn0264253,24
2L,14347358,14348706,1348,1227,3,FBtr0080641,FBgn0028530,16
2L,14349235,14349780,545,475,2,FBtr0080640,FBgn0261534,11
2L,14352156,14352600,444,391,2,FBtr0304632,FBgn0262354,16
2L,14352664,14354997,2333,2159,4,FBtr0080639,FBgn0261535,21
2L,14357208,14358180,972,712,5,FBtr0080627,FBgn0015791,9
2L,14359380,14361275,1895,1895,1,FBtr0080629,FBgn0001970,48
2L,14362138,14365227,3089,2745,6,FBtr0080630,FBgn0015546,26
2L,14378824,14381134,2310,1811,7,FBtr0080638,FBgn0020258,14
2L,14391182,14408436,17254,1653,3,FBtr0080637,FBgn0004858,89
2L,14416838,14417318,480,421,2,FBtr0080634,FBgn0264810,2
2L,14424416,14425131,715,652,2,FBtr0080633,FBgn0028871,27
2L,14450483,14450860,377,377,1,FBtr0300837,FBgn0028844,11
2L,14491246,14493158,1912,1609,2,FBtr0080643,FBgn0005771,43
2L,14524511,14525622,1111,527,4,FBtr0343695,FBgn0053648,25
2L,14547644,14548953,1309,840,3,FBtr0080662,FBgn0250844,32
2L,14563127,14563579,452,452,1,FBtr0080661,FBgn0028913,0
2L,14587991,14588234,243,178,2,FBtr0302802,FBgn0261566,4
2L,14600682,14688678,87996,4660,11,FBtr0301494,FBgn0003016,54
2L,14616339,14617241,902,765,3,FBtr0100589,FBgn0000055,9
2L,14617548,14618840,1292,813,3,FBtr0006151,FBgn0000056,9
2L,14712742,14713049,307,235,2,FBtr0080656,FBgn0028855,6
2L,14713829,14714216,387,295,2,FBtr0112356,FBgn0085194,8
2L,14724661,14730001,5340,4777,5,FBtr0302857,FBgn0261571,60
2L,14735951,14736997,1046,1046,1,FBtr0080667,FBgn0051835,35
2L,14737397,14737730,333,265,2,FBtr0080691,FBgn0028537,9
2L,14740022,14741068,1046,1046,1,FBtr0301738,FBgn0260953,39
2L,14741468,14741801,333,265,2,FBtr0301740,FBgn0260954,7
2L,14743296,14743615,319,244,2,FBtr0112357,FBgn0085195,6
2L,14744435,14744814,379,325,2,FBtr0302803,FBgn0261567,22
2L,14744952,14745185,233,145,2,FBtr0301742,FBgn0260955,3
2L,14760971,14761756,785,785,1,FBtr0080670,FBgn0028870,17
2L,14762861,14763952,1091,1091,1,FBtr0080671,FBgn0028838,16
2L,14766007,14767158,1151,1151,1,FBtr0080672,FBgn0028868,18
2L,14773876,14774976,1100,893,4,FBtr0301695,FBgn0032549,23
2L,14783345,14784586,1241,1043,4,FBtr0080688,FBgn0032551,17
2L,14795371,14796537,1166,893,4,FBtr0080687,FBgn0028866,36
2L,14802438,14803064,626,574,2,FBtr0080673,FBgn0250834,26
2L,14810807,14812582,1775,1714,2,FBtr0080674,FBgn0053309,25
2L,14842387,14843098,711,628,2,FBtr0343681,FBgn0261568,6
2L,14845120,14849122,4002,1911,6,FBtr0080685,FBgn0028886,23
2L,14870972,14871957,985,812,4,FBtr0304003,FBgn0032553,16
2L,14875402,14876068,666,476,4,FBtr0343682,FBgn0032554,16
2L,14879132,14879618,486,436,2,FBtr0080682,FBgn0013300,8
2L,14882207,14882687,480,430,2,FBtr0080681,FBgn0013301,4
2L,14908524,14963046,54522,3173,19,FBtr0299711,FBgn0259213,79
2L,14924735,14930253,5518,5400,3,FBtr0080675,FBgn0028887,71
2L,14976319,14992471,16152,1416,6,FBtr0080676,FBgn0086711,15
2L,15005825,15006536,711,564,3,FBtr0080693,FBgn0040228,3
2L,15006648,15007341,693,643,2,FBtr0080728,FBgn0261881,13
2L,15007918,15008466,548,548,1,FBtr0080695,FBgn0028926,12
2L,15008685,15009597,912,856,2,FBtr0080727,FBgn0283659,20
2L,15010018,15011355,1337,1279,2,FBtr0080696,FBgn0286027,14
2L,15021095,15032654,11559,2508,15,FBtr0304731,FBgn0260446,23
2L,15026882,15029509,2627,2627,1,FBtr0343684,FBgn0053310,88
2L,15030979,15031720,741,679,2,FBtr0343688,FBgn0051832,29
2L,15035564,15037725,2161,1311,3,FBtr0080699,FBgn0041713,5
2L,15037875,15038775,900,741,3,FBtr0080725,FBgn0001977,8
2L,15039937,15042615,2678,1778,4,FBtr0080700,FBgn0004837,17
2L,15045417,15053431,8014,6490,11,FBtr0080723,FBgn0000317,36
2L,15058303,15058884,581,517,2,FBtr0091659,FBgn0053679,15
2L,15059494,15060498,1004,937,2,FBtr0080722,FBgn0010422,7
2L,15064437,15067627,3190,1467,3,FBtr0080718,FBgn0024183,22
2L,15068406,15074160,5754,1976,7,FBtr0445185,FBgn0283442,31
2L,15075645,15095726,20081,3997,17,FBtr0080702,FBgn0028879,68
2L,15109585,15112911,3326,1759,2,FBtr0080704,FBgn0028878,31
2L,15113890,15117652,3762,3313,5,FBtr0080705,FBgn0001978,50
2L,15163585,15178320,14735,3985,5,FBtr0305559,FBgn0028888,49
2L,15201710,15202064,354,240,3,FBtr0300311,FBgn0259965,4
2L,15215432,15215670,238,166,2,FBtr0306282,FBgn0262875,9
2L,15228932,15247594,18662,1408,8,FBtr0080714,FBgn0028516,29
2L,15249139,15253538,4399,2640,6,FBtr0080707,FBgn0028862,36
2L,15254971,15256263,1292,1292,1,FBtr0303164,FBgn0283467,20
2L,15256651,15257187,536,484,2,FBtr0080708,FBgn0259982,6
2L,15257416,15264126,6710,2658,12,FBtr0080709,FBgn0045842,49
2L,15266377,15270964,4587,2309,10,FBtr0302156,FBgn0261268,15
2L,15274272,15274986,714,411,3,FBtr0080746,FBgn0086691,3
2L,15285027,15285902,875,875,1,FBtr0080729,FBgn0028853,22
2L,15291484,15292173,689,689,1,FBtr0300846,FBgn0028850,15
2L,15292737,15293258,521,396,3,FBtr0080731,FBgn0011239,0
2L,15297947,15299260,1313,1313,1,FBtr0080733,FBgn0028852,25
2L,15318112,15318846,734,734,1,FBtr0300021,FBgn0041103,9
2L,15334094,15335503,1409,1409,1,FBtr0080734,FBgn0001981,25
2L,15361001,15361588,587,587,1,FBtr0080743,FBgn0032563,17
2L,15417957,15418239,282,226,2,FBtr0343713,FBgn0266163,4
2L,15423725,15425430,1705,1642,2,FBtr0080740,FBgn0001983,24
2L,15433455,15434906,1451,1451,1,FBtr0080735,FBgn0028892,11
2L,15476938,15478107,1169,1169,1,FBtr0080739,FBgn0003448,17
2L,15484837,15485364,527,527,1,FBtr0089699,FBgn0020371,12
2L,15499221,15503912,4691,1787,4,FBtr0080738,FBgn0002524,26
2L,15547565,15548018,453,397,2,FBtr0300217,FBgn0259922,11
2L,15550472,15551118,646,435,3,FBtr0300847,FBgn0028880,15
2L,15578953,15583023,4070,3061,2,FBtr0080752,FBgn0028370,49
2L,15610903,15611685,782,782,1,FBtr0080785,FBgn0028950,9
2L,15612521,15613326,805,751,2,FBtr0080784,FBgn0028944,9
2L,15613974,15614791,817,760,2,FBtr0080783,FBgn0028949,7
2L,15615522,15616333,811,757,2,FBtr0080782,FBgn0028948,28
2L,15617002,15617791,789,718,2,FBtr0080753,FBgn0028947,30
2L,15622131,15623558,1427,1223,4,FBtr0080781,FBgn0028946,14
2L,15628684,15629507,823,760,2,FBtr0080754,FBgn0028945,15
2L,15630193,15632091,1898,1646,4,FBtr0080755,FBgn0028518,33
2L,15647838,15714237,66399,3797,16,FBtr0344773,FBgn0028863,37
2L,15659269,15659445,176,176,1,FBtr0335468,FBgn0264990,2
2L,15661046,15662667,1621,1390,2,FBtr0080756,FBgn0028864,8
2L,15670239,15671220,981,880,2,FBtr0080757,FBgn0028517,9
2L,15675658,15676059,401,401,1,FBtr0333240,FBgn0264544,8
2L,15694266,15694442,176,176,1,FBtr0335467,FBgn0264989,2
2L,15696043,15697664,1621,1390,2,FBtr0080758,FBgn0051780,11
2L,15705236,15706217,981,880,2,FBtr0080759,FBgn0051827,18
2L,15710655,15711056,401,401,1,FBtr0333239,FBgn0264545,10
2L,15728884,15740791,11907,2122,5,FBtr0080773,FBgn0010382,49
2L,15749708,15750976,1268,498,3,FBtr0080771,FBgn0001989,9
2L,15752357,15755574,3217,3163,2,FBtr0080760,FBgn0001986,20
2L,15757099,15760568,3469,2862,6,FBtr0080765,FBgn0001987,44
2L,15764376,15765708,1332,1007,4,FBtr0080761,FBgn0028507,8
2L,15766638,15768231,1593,1406,4,FBtr0080764,FBgn0001990,14
2L,15768742,15771064,2322,2092,5,FBtr0080763,FBgn0041627,45
2L,15771347,15772541,1194,800,4,FBtr0331280,FBgn0051826,9
2L,15776536,15776769,233,233,1,FBtr0331279,FBgn0264260,6
2L,15784255,15790047,5792,5792,1,FBtr0080786,FBgn0028901,126
2L,15811344,15812130,786,727,2,FBtr0304142,FBgn0262150,35
2L,15834613,15835608,995,995,1,FBtr0080814,FBgn0028900,15
2L,15852697,15853963,1266,1213,2,FBtr0080787,FBgn0028903,11
2L,15854363,15856273,1910,1752,3,FBtr0080788,FBgn0028902,21
2L,15865095,15865423,328,262,2,FBtr0303589,FBgn0261925,12
2L,15877618,15879460,1842,1575,3,FBtr0306681,FBgn0028935,32
2L,15882866,15883173,307,241,2,FBtr0340573,FBgn0265668,4
2L,15888705,15893719,5014,4053,9,FBtr0080811,FBgn0041183,60
2L,15895897,15896998,1101,933,3,FBtr0080790,FBgn0051735,13
2L,15898923,15900446,1523,1278,3,FBtr0080810,FBgn0051823,19
2L,15901044,15902377,1333,1279,2,FBtr0080809,FBgn0051821,16
2L,15905680,15939433,33753,975,6,FBtr0080808,FBgn0028645,20
2L,15916938,15917352,414,304,2,FBtr0080792,FBgn0032577,1
2L,15923410,15926200,2790,2728,2,FBtr0300612,FBgn0028514,46
2L,15941506,15942682,1176,1053,3,FBtr0300613,FBgn0028857,18
2L,15957941,15959347,1406,1111,5,FBtr0300064,FBgn0028856,19
2L,15979572,15980117,545,545,1,FBtr0080800,FBgn0028858,12
2L,16003064,16003444,380,380,1,FBtr0112358,FBgn0085196,14
2L,16004694,16004852,158,158,1,FBtr0332229,FBgn0264364,10
2L,16005110,16005349,239,239,1,FBtr0080802,FBgn0045827,2
2L,16005909,16006094,185,185,1,FBtr0080807,FBgn0051820,1
2L,16014135,16039527,25392,1595,7,FBtr0080801,FBgn0028644,46
2L,16043087,16043218,131,131,1,FBtr0344488,FBgn0266459,3
2L,16044055,16048202,4147,2706,9,FBtr0080803,FBgn0000182,61
2L,16056275,16080894,24619,1274,7,FBtr0080806,FBgn0013433,26
2L,16095036,16095941,905,905,1,FBtr0080815,FBgn0028520,21
2L,16133716,16134285,569,569,1,FBtr0080816,FBgn0028884,11
2L,16134909,16135088,179,179,1,FBtr0112359,FBgn0085197,5
2L,16170708,16189082,18374,6871,29,FBtr0090003,FBgn0001991,148
2L,16173110,16189744,16634,6039,30,FBtr0332021,FBgn0001991,107
2L,16211588,16213234,1646,1488,3,FBtr0080821,FBgn0028893,18
2L,16232074,16239920,7846,3634,11,FBtr0303797,FBgn0261999,37
2L,16242081,16245456,3375,3252,3,FBtr0303798,FBgn0262000,220
2L,16247078,16248950,1872,524,4,FBtr0080856,FBgn0024734,2
2L,16251633,16251758,125,125,1,FBtr0452124,FBgn0284225,1
2L,16258114,16259259,1145,1075,2,FBtr0080824,FBgn0028515,20
2L,16260228,16261505,1277,1277,1,FBtr0080855,FBgn0002673,22
2L,16262200,16263383,1183,919,5,FBtr0080825,FBgn0028897,20
2L,16265524,16287189,21665,1890,3,FBtr0080854,FBgn0001994,39
2L,16288444,16290776,2332,1862,4,FBtr0080826,FBgn0040079,42
2L,16291342,16291827,485,485,1,FBtr0080827,FBgn0028896,12
2L,16292130,16292970,840,610,2,FBtr0080853,FBgn0032582,9
2L,16294351,16295859,1508,1508,1,FBtr0080828,FBgn0001992,14
2L,16297558,16299312,1754,1075,2,FBtr0080852,FBgn0028375,11
2L,16299983,16301605,1622,1144,2,FBtr0337079,FBgn0028895,20
2L,16302080,16302773,693,410,4,FBtr0080851,FBgn0028894,2
2L,16303352,16305476,2124,1702,8,FBtr0080830,FBgn0028525,36
2L,16305962,16307014,1052,677,4,FBtr0080850,FBgn0015338,13
2L,16307660,16309128,1468,1399,2,FBtr0080831,FBgn0011708,17
2L,16309906,16310590,684,428,4,FBtr0080848,FBgn0000339,2
2L,16311101,16312824,1723,1575,3,FBtr0080833,FBgn0001086,17
2L,16313382,16325027,11645,1494,6,FBtr0080844,FBgn0000250,22
2L,16327157,16328032,875,875,1,FBtr0080834,FBgn0014092,20
2L,16328133,16329082,949,886,2,FBtr0080843,FBgn0001995,29
2L,16330008,16330303,295,235,2,FBtr0080835,FBgn0040984,10
2L,16330626,16337807,7181,7056,3,FBtr0307508,FBgn0028899,322
2L,16338164,16340307,2143,1706,7,FBtr0299599,FBgn0259151,60
2L,16340471,16342243,1772,1772,1,FBtr0340235,FBgn0265578,51
2L,16342609,16352026,9417,723,3,FBtr0273183,FBgn0087041,18
2L,16343200,16349453,6253,5131,2,FBtr0080838,FBgn0000307,80
2L,16353095,16353550,455,376,2,FBtr0080836,FBgn0028506,8
2L,16355185,16356552,1367,1297,2,FBtr0080837,FBgn0025678,31
2L,16365919,16366873,954,889,2,FBtr0080859,FBgn0028841,23
2L,16400504,16405924,5420,1362,3,FBtr0080880,FBgn0028523,25
2L,16445329,16446716,1387,1315,2,FBtr0080860,FBgn0020416,19
2L,16447397,16450455,3058,1317,3,FBtr0080861,FBgn0020415,16
2L,16451190,16452846,1656,1320,3,FBtr0080862,FBgn0020414,26
2L,16467624,16484742,17118,3206,10,FBtr0080875,FBgn0005677,171
2L,16488203,16490112,1909,1855,2,FBtr0080865,FBgn0032585,91
2L,16491912,16507014,15102,1520,4,FBtr0080866,FBgn0032586,27
2L,16510139,16528184,18045,2101,2,FBtr0080873,FBgn0032587,97
2L,16542673,16543172,499,289,2,FBtr0080868,FBgn0051816,8
2L,16549354,16549886,532,475,2,FBtr0080872,FBgn0032588,6
2L,16558129,16661775,103646,6188,4,FBtr0300003,FBgn0259735,203
2L,16605946,16607274,1328,1328,1,FBtr0080870,FBgn0051815,46
2L,16607490,16609877,2387,2387,1,FBtr0080871,FBgn0032590,94
2L,16664889,16669420,4531,3370,14,FBtr0080945,FBgn0032593,60
2L,16677383,16678972,1589,1458,3,FBtr0080883,FBgn0001185,23
2L,16680719,16681441,722,722,1,FBtr0080887,FBgn0267347,20
2L,16681902,16682366,464,464,1,FBtr0080944,FBgn0051807,5
2L,16682619,16683089,470,470,1,FBtr0091522,FBgn0053552,5
2L,16691089,16699638,8549,1530,6,FBtr0080884,FBgn0261278,22
2L,16705525,16705692,167,167,1,FBtr0303445,FBgn0062978,2
2L,16719135,16719449,314,314,1,FBtr0080888,FBgn0086907,5
2L,16722050,16722373,323,323,1,FBtr0080889,FBgn0284248,7
2L,16723822,16727666,3844,1398,6,FBtr0080940,FBgn0027779,19
2L,16729778,16730530,752,697,2,FBtr0290062,FBgn0051812,18
2L,16730554,16730960,406,352,2,FBtr0080937,FBgn0032595,6
2L,16731292,16732033,741,600,3,FBtr0080936,FBgn0032596,7
2L,16732632,16733564,932,932,1,FBtr0080891,FBgn0032597,17
2L,16733800,16738277,4477,4222,5,FBtr0080935,FBgn0015391,49
2L,16738996,16742222,3226,1727,4,FBtr0080892,FBgn0032598,43
2L,16742672,16743060,388,328,2,FBtr0080934,FBgn0261068,2
2L,16743530,16745149,1619,1067,4,FBtr0080893,FBgn0032600,33
2L,16755699,16758062,2363,1357,2,FBtr0080894,FBgn0032601,25
2L,16758353,16760113,1760,1285,8,FBtr0080933,FBgn0032602,17
2L,16768681,16788101,19420,5869,17,FBtr0080895,FBgn0264695,76
2L,16788934,16790632,1698,1305,3,FBtr0080932,FBgn0000406,14
2L,16791772,16793320,1548,1319,4,FBtr0080908,FBgn0032603,33
2L,16794236,16795804,1568,1568,1,FBtr0080909,FBgn0040262,30
2L,16796595,16798270,1675,1615,2,FBtr0080910,FBgn0040261,51
2L,16799808,16801515,1707,1627,2,FBtr0080911,FBgn0040260,32
2L,16802144,16821006,18862,1414,5,FBtr0080931,FBgn0032609,38
2L,16811665,16815790,4125,2524,2,FBtr0080914,FBgn0086673,87
2L,16820123,16826713,6590,1686,9,FBtr0080915,FBgn0004797,17
2L,16821327,16825066,3739,2918,7,FBtr0080930,FBgn0022213,26
2L,16827724,16831375,3651,3240,6,FBtr0080919,FBgn0051739,23
2L,16832196,16833900,1704,1448,4,FBtr0080929,FBgn0032612,32
2L,16835263,16837218,1955,1955,1,FBtr0080928,FBgn0032613,44
2L,16839227,16839310,83,83,1,FBtr0344543,FBgn0266491,0
2L,16840296,16840382,86,86,1,FBtr0344539,FBgn0266492,0
2L,16843281,16846928,3647,970,5,FBtr0080926,FBgn0032614,12
2L,16849148,16852332,3184,967,5,FBtr0080925,FBgn0051810,6
2L,16853749,16858453,4704,943,5,FBtr0113414,FBgn0051809,6
2L,16860076,16861419,1343,921,3,FBtr0080923,FBgn0032615,24
2L,16878604,16879216,612,417,3,FBtr0080960,FBgn0052832,2
2L,16879546,16881430,1884,840,3,FBtr0112511,FBgn0085342,23
2L,16881514,16886022,4508,984,3,FBtr0080947,FBgn0032618,4
2L,16887465,16887834,369,253,2,FBtr0080959,FBgn0040985,7
2L,16889003,16916561,27558,15262,23,FBtr0304927,FBgn0261671,141
2L,16890273,16891043,770,770,1,FBtr0301255,FBgn0260758,14
2L,16898265,16900419,2154,1918,5,FBtr0304932,FBgn0051805,20
2L,16900725,16902151,1426,1302,3,FBtr0080957,FBgn0032620,21
2L,16908319,16910157,1838,1838,1,FBtr0080956,FBgn0026150,23
2L,16976975,16990470,13495,647,4,FBtr0273450,FBgn0053179,12
2L,16981917,16982301,384,279,3,FBtr0340238,FBgn0265579,6
2L,16985078,16985530,452,452,1,FBtr0080952,FBgn0051806,8
2L,17011609,17012935,1326,1264,2,FBtr0080955,FBgn0032624,21
2L,17047251,17047981,730,568,2,FBtr0080954,FBgn0032625,18
2L,17087725,17088585,860,860,1,FBtr0080953,FBgn0032626,25
2L,17123394,17125875,2481,2286,3,FBtr0302499,FBgn0051784,57
2L,17133618,17170426,36808,1023,6,FBtr0303301,FBgn0265607,22
2L,17171480,17171845,365,365,1,FBtr0110785,FBgn0083942,7
2L,17173597,17173968,371,371,1,FBtr0112360,FBgn0085198,6
2L,17176618,17177918,1300,1170,3,FBtr0080962,FBgn0045487,35
2L,17178781,17180061,1280,1170,3,FBtr0080963,FBgn0045486,36
2L,17180338,17181629,1291,1167,3,FBtr0080964,FBgn0045485,30
2L,17181938,17183651,1713,1227,3,FBtr0080965,FBgn0046888,22
2L,17189953,17251563,61610,1144,5,FBtr0080971,FBgn0032629,46
2L,17286294,17287456,1162,1002,3,FBtr0302408,FBgn0032631,39
2L,17291230,17292108,878,878,1,FBtr0080970,FBgn0032632,14
2L,17311574,17311759,185,185,1,FBtr0112361,FBgn0085199,3
2L,17320321,17320530,209,209,1,FBtr0346474,FBgn0267255,22
2L,17363597,17364232,635,635,1,FBtr0080967,FBgn0051804,16
2L,17368200,17383782,15582,2420,7,FBtr0080968,FBgn0032633,33
2L,17385631,17409402,23771,5052,15,FBtr0080975,FBgn0020503,116
2L,17409761,17410304,543,347,4,FBtr0081011,FBgn0032634,0
2L,17410781,17413168,2387,1210,2,FBtr0080979,FBgn0032635,20
2L,17411689,17412587,898,841,2,FBtr0081010,FBgn0051803,3
2L,17413518,17420093,6575,1995,6,FBtr0081008,FBgn0011274,30
2L,17433974,17435651,1677,1493,4,FBtr0080980,FBgn0032636,23
2L,17435894,17436600,706,536,4,FBtr0091932,FBgn0053928,11
2L,17437051,17442986,5935,2023,8,FBtr0081005,FBgn0260632,57
2L,17453225,17458743,5518,977,4,FBtr0080981,FBgn0032637,19
2L,17454341,17455896,1555,1480,2,FBtr0081004,FBgn0032638,24
2L,17456765,17458025,1260,1134,3,FBtr0300902,FBgn0032639,30
2L,17461669,17472324,10655,2398,8,FBtr0330226,FBgn0000183,12
2L,17473588,17474580,992,992,1,FBtr0080982,FBgn0032640,18
2L,17475591,17477717,2126,1601,7,FBtr0081001,FBgn0027885,17
2L,17478538,17480901,2363,2250,3,FBtr0080999,FBgn0024689,37
2L,17481334,17481783,449,370,2,FBtr0080983,FBgn0032642,2
2L,17482450,17484158,1708,1642,2,FBtr0080998,FBgn0032643,34
2L,17484578,17485499,921,847,2,FBtr0080984,FBgn0032644,11
2L,17485791,17486002,211,100,2,FBtr0445728,FBgn0262857,1
2L,17486153,17486337,184,106,2,FBtr0445727,FBgn0263654,3
2L,17486597,17486776,179,103,2,FBtr0310202,FBgn0262856,1
2L,17486964,17496761,9797,2654,7,FBtr0080996,FBgn0003187,26
2L,17498090,17498762,672,616,2,FBtr0080995,FBgn0032645,10
2L,17499402,17500668,1266,951,3,FBtr0080994,FBgn0032646,12
2L,17501467,17525451,23984,12049,23,FBtr0304742,FBgn0013810,90
2L,17520921,17524521,3600,3453,3,FBtr0080993,FBgn0032647,64
2L,17525706,17528995,3289,3110,4,FBtr0303652,FBgn0032648,34
2L,17529470,17532234,2764,2625,3,FBtr0080991,FBgn0032649,34
2L,17554442,17555611,1169,1169,1,FBtr0080990,FBgn0032650,9
2L,17590240,17590995,755,694,2,FBtr0080986,FBgn0032651,32
2L,17591701,17592111,410,410,1,FBtr0080989,FBgn0032652,11
2L,17592324,17603285,10961,1506,6,FBtr0303254,FBgn0261089,17
2L,17625781,17626218,437,437,1,FBtr0080988,FBgn0032654,8
2L,17627901,17628308,407,407,1,FBtr0304636,FBgn0262356,16
2L,17650387,17739518,89131,9267,21,FBtr0081013,FBgn0015609,110
2L,17704842,17705068,226,163,2,FBtr0306283,FBgn0262876,6
2L,17788308,17827472,39164,5384,13,FBtr0303836,FBgn0262018,85
2L,17812044,17812604,560,560,1,FBtr0303837,FBgn0262017,9
2L,17914555,17914671,116,116,1,FBtr0306711,FBgn0262960,3
2L,17962738,17982472,19734,12683,25,FBtr0273418,FBgn0023096,121
2L,17963546,17973390,9844,1463,4,FBtr0081021,FBgn0032656,34
2L,17986528,17988132,1604,1604,1,FBtr0081024,FBgn0032658,17
2L,17990499,17991335,836,836,1,FBtr0081025,FBgn0051742,17
2L,18006783,18006998,215,215,1,FBtr0081026,FBgn0040989,5
2L,18007568,18007714,146,146,1,FBtr0303712,FBgn0261531,1
2L,18007994,18008335,341,341,1,FBtr0302275,FBgn0261357,14
2L,18008428,18008823,395,395,1,FBtr0302276,FBgn0261358,5
2L,18009308,18009490,182,182,1,FBtr0081028,FBgn0051740,4
2L,18010500,18011376,876,683,4,FBtr0302030,FBgn0032660,13
2L,18051461,18069390,17929,2211,12,FBtr0081029,FBgn0243486,51
2L,18078388,18080191,1803,1088,4,FBtr0081030,FBgn0000120,6
2L,18081665,18083457,1792,1534,5,FBtr0081031,FBgn0002939,13
2L,18084268,18086153,1885,1469,4,FBtr0081032,FBgn0051741,22
2L,18090944,18092238,1294,1090,2,FBtr0081045,FBgn0032663,29
2L,18096692,18098041,1349,1349,1,FBtr0081033,FBgn0032664,8
2L,18112845,18113135,290,229,2,FBtr0340579,FBgn0265669,3
2L,18114683,18115018,335,335,1,FBtr0081034,FBgn0032665,3
2L,18123605,18128941,5336,1868,7,FBtr0081035,FBgn0032666,23
2L,18124131,18125435,1304,1137,3,FBtr0300025,FBgn0051785,14
2L,18130777,18137931,7154,4425,6,FBtr0081043,FBgn0001301,77
2L,18139536,18142527,2991,2208,3,FBtr0329928,FBgn0041184,66
2L,18153417,18154407,990,876,3,FBtr0081038,FBgn0032668,25
2L,18154866,18155822,956,770,4,FBtr0081048,FBgn0032669,6
2L,18156077,18157104,1027,857,4,FBtr0081049,FBgn0032670,11
2L,18157212,18158540,1328,1273,2,FBtr0081062,FBgn0032671,24
2L,18161432,18210860,49428,3193,11,FBtr0303280,FBgn0261804,90
2L,18182072,18184117,2045,2045,1,FBtr0081061,FBgn0267486,33
2L,18208591,18209148,557,557,1,FBtr0081058,FBgn0051802,1
2L,18257602,18257838,236,175,2,FBtr0081056,FBgn0051788,7
2L,18284939,18285634,695,695,1,FBtr0081055,FBgn0051787,7
2L,18291275,18291428,153,94,2,FBtr0307109,FBgn0263094,2
2L,18292548,18292710,162,103,2,FBtr0301937,FBgn0261057,2
2L,18295149,18297143,1994,1994,1,FBtr0081050,FBgn0032677,36
2L,18309256,18309407,151,94,2,FBtr0307101,FBgn0263086,3
2L,18320688,18392106,71418,1517,7,FBtr0081051,FBgn0000636,31
2L,18356228,18359022,2794,2734,2,FBtr0081054,FBgn0011559,59
2L,18378626,18379616,990,873,3,FBtr0305066,FBgn0085200,10
2L,18442721,18443062,341,341,1,FBtr0081089,FBgn0261597,7
2L,18444645,18448854,4209,3987,3,FBtr0081088,FBgn0086707,63
2L,18449637,18454486,4849,4231,5,FBtr0081087,FBgn0284256,51
2L,18454767,18455156,389,389,1,FBtr0081063,FBgn0032680,8
2L,18473222,18483969,10747,2181,9,FBtr0081085,FBgn0032681,54
2L,18485968,18487195,1227,720,3,FBtr0300674,FBgn0032682,9
2L,18488077,18500800,12723,7132,11,FBtr0300341,FBgn0032683,63
2L,18511623,18513334,1711,1587,3,FBtr0081068,FBgn0032684,16
2L,18518181,18531656,13475,4173,9,FBtr0081069,FBgn0032685,51
2L,18533338,18546717,13379,4337,16,FBtr0112544,FBgn0085370,104
2L,18591214,18594206,2992,2458,8,FBtr0081070,FBgn0032688,33
2L,18596313,18596906,593,593,1,FBtr0081081,FBgn0003270,16
2L,18600613,18604920,4307,2816,7,FBtr0081080,FBgn0032689,28
2L,18605942,18606354,412,349,2,FBtr0081071,FBgn0051789,4
2L,18606924,18609452,2528,2464,2,FBtr0081072,FBgn0032690,33
2L,18609610,18612178,2568,2317,5,FBtr0081079,FBgn0032691,49
2L,18614447,18615819,1372,1246,2,FBtr0081078,FBgn0032692,32
2L,18649625,18661048,11423,841,2,FBtr0081073,FBgn0032694,12
2L,18651174,18652944,1770,1470,6,FBtr0081077,FBgn0032693,21
2L,18666968,18669966,2998,2473,5,FBtr0306921,FBgn0263079,31
2L,18671785,18673215,1430,1214,4,FBtr0306920,FBgn0263078,24
2L,18673450,18675033,1583,1406,4,FBtr0302267,FBgn0261349,23
2L,18675266,18676932,1666,1490,4,FBtr0305341,FBgn0086681,22
2L,18678854,18683262,4408,1248,3,FBtr0081092,FBgn0086909,17
2L,18679708,18681958,2250,2194,2,FBtr0081131,FBgn0015553,41
2L,18685249,18688425,3176,3115,2,FBtr0081130,FBgn0005617,33
2L,18689794,18690714,920,920,1,FBtr0081095,FBgn0032698,19
2L,18691120,18695124,4004,2348,4,FBtr0089628,FBgn0032699,31
2L,18696142,18697882,1740,1247,4,FBtr0081096,FBgn0032700,11
2L,18698835,18700585,1750,1690,2,FBtr0081097,FBgn0032701,29
2L,18701630,18702913,1283,1283,1,FBtr0081128,FBgn0032702,22
2L,18703553,18704333,780,639,3,FBtr0081098,FBgn0032703,5
2L,18704757,18705503,746,746,1,FBtr0343116,FBgn0032704,12
2L,18706536,18708238,1702,1389,3,FBtr0081126,FBgn0025608,25
2L,18708938,18711051,2113,1934,4,FBtr0081099,FBgn0032705,26
2L,18711340,18713535,2195,1321,5,FBtr0081125,FBgn0032706,23
2L,18714833,18716452,1619,1619,1,FBtr0301647,FBgn0032707,38
2L,18739521,18740006,485,485,1,FBtr0303282,FBgn0261806,8
2L,18740410,18740757,347,347,1,FBtr0081101,FBgn0032709,6
2L,18763497,18780005,16508,2963,7,FBtr0305620,FBgn0045852,78
2L,18805126,18805236,110,110,1,FBtr0332209,FBgn0264362,1
2L,18810264,18810482,218,218,1,FBtr0081122,FBgn0040992,3
2L,18810588,18810871,283,148,2,FBtr0300635,FBgn0260228,1
2L,18813100,18813397,297,142,2,FBtr0299686,FBgn0259201,0
2L,18813461,18813691,230,230,1,FBtr0081102,FBgn0040993,1
2L,18820256,18822545,2289,1570,5,FBtr0300818,FBgn0027074,52
2L,18824306,18826200,1894,1553,4,FBtr0081104,FBgn0032713,31
2L,18827002,18828861,1859,1548,3,FBtr0081105,FBgn0027070,24
2L,18829076,18830584,1508,1217,4,FBtr0081121,FBgn0032715,12
2L,18831342,18833492,2150,1627,5,FBtr0081109,FBgn0015808,18
2L,18834501,18839393,4892,4123,8,FBtr0081120,FBgn0032717,53
2L,18839932,18841278,1346,1227,3,FBtr0331193,FBgn0051752,24
2L,18841481,18844426,2945,2063,4,FBtr0081118,FBgn0053120,22
2L,18853112,18854501,1389,1114,5,FBtr0081110,FBgn0032719,21
2L,18855256,18857338,2082,1835,4,FBtr0089314,FBgn0032721,16
2L,18858077,18859160,1083,531,3,FBtr0089318,FBgn0032720,9
2L,18860690,18880795,20105,1593,9,FBtr0081111,FBgn0003896,40
2L,18916981,18943466,26485,5185,11,FBtr0081193,FBgn0032723,59
2L,18946386,18946556,170,170,1,FBtr0452098,FBgn0284082,1
2L,18948998,18950921,1923,1751,4,FBtr0081132,FBgn0032724,21
2L,18951244,18951715,471,249,3,FBtr0081192,FBgn0032725,4
2L,18952342,18953560,1218,990,3,FBtr0081191,FBgn0032726,18
2L,18955947,18957045,1098,991,2,FBtr0081190,FBgn0032727,23
2L,18958303,18968415,10112,4456,8,FBtr0081187,FBgn0015772,41
2L,18969099,18971979,2880,2760,3,FBtr0081133,FBgn0032728,41
2L,18972163,18974038,1875,1362,3,FBtr0081186,FBgn0032729,22
2L,18974777,18977119,2342,2284,2,FBtr0081134,FBgn0032730,20
2L,18978358,18986910,8552,649,2,FBtr0081185,FBgn0032731,8
2L,18987789,18988248,459,324,3,FBtr0081135,FBgn0032732,1
2L,18988297,18990227,1930,1680,3,FBtr0081184,FBgn0032733,43
2L,18991075,18992109,1034,1034,1,FBtr0081136,FBgn0032734,23
2L,18993789,18995854,2065,1271,4,FBtr0081183,FBgn0046302,28
2L,18997979,19002452,4473,3960,9,FBtr0321311,FBgn0051792,68
2L,19003669,19008050,4381,3915,6,FBtr0081138,FBgn0051793,48
2L,19008378,19009115,737,331,2,FBtr0081181,FBgn0086710,6
2L,19010996,19011340,344,344,1,FBtr0081139,FBgn0028569,12
2L,19023179,19023523,344,344,1,FBtr0081140,FBgn0032740,4
2L,19028057,19030460,2403,1518,3,FBtr0081141,FBgn0032741,33
2L,19031006,19033380,2374,2030,7,FBtr0081180,FBgn0001202,30
2L,19033742,19034456,714,542,4,FBtr0081179,FBgn0051800,8
2L,19035799,19041119,5320,3142,5,FBtr0081142,FBgn0086442,44
2L,19041946,19043347,1401,1345,2,FBtr0081143,FBgn0002022,23
2L,19043623,19044903,1280,1103,4,FBtr0081178,FBgn0032744,11
2L,19045567,19048093,2526,2212,5,FBtr0081144,FBgn0263198,44
2L,19049175,19049831,656,546,3,FBtr0081146,FBgn0032746,3
2L,19049892,19051498,1606,1543,2,FBtr0081177,FBgn0002021,23
2L,19052054,19053596,1542,1480,2,FBtr0302289,FBgn0261396,17
2L,19054851,19057517,2666,2427,3,FBtr0081148,FBgn0032748,59
2L,19059647,19063046,3399,2857,5,FBtr0081149,FBgn0032749,44
2L,19063382,19064630,1248,1186,2,FBtr0081150,FBgn0032750,17
2L,19064993,19065244,251,251,1,FBtr0081151,FBgn0032751,2
2L,19065305,19068577,3272,2832,6,FBtr0081174,FBgn0032752,48
2L,19071195,19074024,2829,1149,6,FBtr0081173,FBgn0032753,30
2L,19077379,19078995,1616,1616,1,FBtr0081171,FBgn0032754,51
2L,19080099,19106071,25972,1658,7,FBtr0329940,FBgn0002023,83
2L,19102168,19102347,179,179,1,FBtr0330018,FBgn0263982,4
2L,19102388,19102849,461,461,1,FBtr0081152,FBgn0032755,21
2L,19110271,19114008,3737,1527,3,FBtr0081153,FBgn0000075,40
2L,19114836,19116409,1573,1510,2,FBtr0081155,FBgn0002036,26
2L,19116784,19119235,2451,1423,2,FBtr0081166,FBgn0000422,21
2L,19122422,19123552,1130,826,2,FBtr0081164,FBgn0002031,13
2L,19124054,19126923,2869,2678,4,FBtr0081163,FBgn0086444,27
2L,19127273,19128958,1685,1436,4,FBtr0081156,FBgn0086445,16
2L,19130046,19131830,1784,1672,2,FBtr0081162,FBgn0086443,16
2L,19132400,19133021,621,553,2,FBtr0081157,FBgn0086446,6
2L,19133055,19133426,371,313,2,FBtr0081161,FBgn0086447,6
2L,19168146,19171256,3110,3110,1,FBtr0081158,FBgn0010300,43
2L,19179950,19181603,1653,1536,3,FBtr0081233,FBgn0032763,36
2L,19182256,19182405,149,149,1,FBtr0302890,FBgn0265263,0
2L,19183195,19183335,140,140,1,FBtr0347275,FBgn0267726,2
2L,19184046,19185652,1606,1367,4,FBtr0081228,FBgn0010097,11
2L,19186129,19189582,3453,2737,8,FBtr0081194,FBgn0010309,47
2L,19190729,19207734,17005,1826,4,FBtr0081195,FBgn0015380,23
2L,19259530,19262133,2603,2603,1,FBtr0081227,FBgn0051797,76
2L,19298439,19299727,1288,1001,4,FBtr0081225,FBgn0032768,15
2L,19300373,19301536,1163,989,4,FBtr0081196,FBgn0032769,5
2L,19339168,19362839,23671,1748,4,FBtr0081224,FBgn0024245,30
2L,19364394,19365345,951,544,2,FBtr0081197,FBgn0032770,7
2L,19370644,19372561,1917,794,4,FBtr0081198,FBgn0032771,11
2L,19381012,19383011,1999,947,4,FBtr0081199,FBgn0032772,30
2L,19383613,19386135,2522,1726,5,FBtr0081222,FBgn0032773,67
2L,19387173,19388534,1361,782,4,FBtr0081219,FBgn0032774,32
2L,19390672,19393631,2959,2074,5,FBtr0081216,FBgn0032775,19
2L,19394229,19395819,1590,1470,3,FBtr0081200,FBgn0051798,6
2L,19401109,19426218,25109,1663,8,FBtr0081210,FBgn0041789,30
2L,19403627,19404499,872,589,2,FBtr0081214,FBgn0041789,7
2L,19417460,19418086,626,556,2,FBtr0081201,FBgn0016675,16
2L,19418318,19418937,619,556,2,FBtr0091498,FBgn0053532,22
2L,19419097,19419677,580,448,2,FBtr0091499,FBgn0053533,10
2L,19427248,19429035,1787,1787,1,FBtr0081204,FBgn0032779,44
2L,19429408,19430127,719,719,1,FBtr0081203,FBgn0032780,16
2L,19430771,19432348,1577,1516,2,FBtr0081205,FBgn0032781,25
2L,19432872,19435303,2431,765,3,FBtr0081206,FBgn0032782,31
2L,19436149,19437834,1685,899,4,FBtr0081207,FBgn0032783,16
2L,19443307,19444619,1312,1042,5,FBtr0081288,FBgn0024230,5
2L,19445186,19447235,2049,1783,5,FBtr0081234,FBgn0003346,14
2L,19447741,19452285,4544,4337,4,FBtr0081287,FBgn0284220,35
2L,19456181,19457590,1409,891,6,FBtr0081237,FBgn0032785,8
2L,19464756,19466288,1532,1532,1,FBtr0301669,FBgn0000964,59
2L,19483163,19484601,1438,1077,6,FBtr0302930,FBgn0032787,11
2L,19484973,19486393,1420,1360,2,FBtr0081240,FBgn0032788,35
2L,19487524,19488528,1004,946,2,FBtr0081242,FBgn0032789,15
2L,19488811,19490071,1260,1049,4,FBtr0081285,FBgn0032790,14
2L,19490486,19491626,1140,1078,2,FBtr0081243,FBgn0032791,15
2L,19491679,19492893,1214,1214,1,FBtr0081284,FBgn0032793,15
2L,19493899,19497381,3482,3181,5,FBtr0081244,FBgn0002044,57
2L,19498238,19502163,3925,3746,4,FBtr0081246,FBgn0040268,69
2L,19503102,19508186,5084,3955,2,FBtr0329963,FBgn0032796,48
2L,19509162,19516492,7330,5012,16,FBtr0081280,FBgn0032797,97
2L,19520585,19525238,4653,4074,9,FBtr0081247,FBgn0032798,65
2L,19525477,19526324,847,720,3,FBtr0081279,FBgn0032799,7
2L,19526772,19532667,5895,2815,8,FBtr0081248,FBgn0032800,56
2L,19527380,19528252,872,681,3,FBtr0081277,FBgn0032801,8
2L,19533809,19536462,2653,1276,5,FBtr0081249,FBgn0053116,14
2L,19535554,19535994,440,440,1,FBtr0081250,FBgn0051697,5
2L,19538496,19539626,1130,1130,1,FBtr0081251,FBgn0032803,26
2L,19540693,19541340,647,528,3,FBtr0081252,FBgn0032804,6
2L,19542817,19545299,2482,1794,3,FBtr0081253,FBgn0003231,57
2L,19545808,19546811,1003,714,3,FBtr0081276,FBgn0032805,11
2L,19549846,19556398,6552,4481,7,FBtr0081254,FBgn0041180,61
2L,19558065,19563046,4981,3526,8,FBtr0331331,FBgn0264845,212
2L,19564338,19565003,665,665,1,FBtr0081256,FBgn0032809,8
2L,19566136,19567293,1157,804,3,FBtr0081257,FBgn0032810,13
2L,19568296,19568997,701,701,1,FBtr0081267,FBgn0005672,13
2L,19577798,19579005,1207,1141,2,FBtr0081258,FBgn0027949,29
2L,19579461,19580130,669,565,2,FBtr0081266,FBgn0032811,15
2L,19580779,19582370,1591,1389,3,FBtr0331245,FBgn0032812,94
2L,19583029,19583927,898,763,2,FBtr0081262,FBgn0032813,13
2L,19584346,19586223,1877,1731,3,FBtr0081259,FBgn0032814,55
2L,19611042,19611119,77,77,1,FBtr0347542,FBgn0267964,0
2L,19611527,19730159,118632,6070,17,FBtr0081260,FBgn0000464,48
2L,19699723,19700922,1199,1199,1,FBtr0081261,FBgn0005590,26
2L,19732654,19735836,3182,2428,8,FBtr0081325,FBgn0032815,33
2L,19736136,19736720,584,465,3,FBtr0081289,FBgn0032816,3
2L,19743223,19756520,13297,11335,8,FBtr0081324,FBgn0032817,195
2L,19757308,19758573,1265,1146,3,FBtr0081323,FBgn0032818,15
2L,19758912,19760910,1998,1808,4,FBtr0081290,FBgn0032819,41
2L,19761643,19762826,1183,1000,2,FBtr0081321,FBgn0032820,14
2L,19766363,19768929,2566,1283,4,FBtr0089320,FBgn0000529,36
2L,19776945,19782792,5847,5523,6,FBtr0081318,FBgn0032821,70
2L,19792227,19792746,519,460,2,FBtr0081291,FBgn0032822,6
2L,19792905,19795746,2841,1097,4,FBtr0081316,FBgn0004811,35
2L,19807526,19957449,149923,6561,15,FBtr0329838,FBgn0263873,178
2L,19813862,19814317,455,455,1,FBtr0081314,FBgn0032824,9
2L,19890250,19892529,2279,1932,6,FBtr0081312,FBgn0032827,22
2L,19911901,19912332,431,373,2,FBtr0081310,FBgn0044811,21
2L,19913058,19913516,458,400,2,FBtr0081309,FBgn0053117,30
2L,19959280,19959884,604,544,2,FBtr0081300,FBgn0032833,5
2L,19960167,19961026,859,665,4,FBtr0100106,FBgn0054051,10
2L,19961442,19961662,220,160,2,FBtr0304123,FBgn0262140,9
2L,19961840,19962298,458,397,2,FBtr0081308,FBgn0032834,6
2L,19962725,19963728,1003,931,2,FBtr0081302,FBgn0032835,38
2L,19964231,19965278,1047,747,6,FBtr0081303,FBgn0032836,17
2L,19965821,19966476,655,595,2,FBtr0332183,FBgn0042129,5
2L,19966950,19967654,704,640,2,FBtr0081306,FBgn0014000,15
2L,19969746,19971816,2070,1701,3,FBtr0332566,FBgn0264443,41
2L,20025116,20025781,665,665,1,FBtr0081350,FBgn0032839,28
2L,20054113,20055220,1107,839,4,FBtr0081327,FBgn0032840,28
2L,20058388,20060723,2335,2202,3,FBtr0081348,FBgn0014127,35
2L,20061877,20063972,2095,1422,6,FBtr0081328,FBgn0019686,7
2L,20064389,20065598,1209,1098,3,FBtr0081347,FBgn0003978,27
2L,20066761,20072669,5908,845,4,FBtr0081331,FBgn0045064,10
2L,20070142,20072188,2046,1930,2,FBtr0343848,FBgn0032843,26
2L,20073919,20075025,1106,500,4,FBtr0089395,FBgn0003141,0
2L,20075857,20089569,13712,3361,2,FBtr0081332,FBgn0004374,63
2L,20079321,20084734,5413,307,2,FBtr0310560,FBgn0263773,6
2L,20090032,20091073,1041,982,2,FBtr0081341,FBgn0032845,22
2L,20091693,20093108,1415,1415,1,FBtr0081333,FBgn0032846,30
2L,20093227,20093768,541,405,3,FBtr0081340,FBgn0032847,0
2L,20094209,20096162,1953,1803,3,FBtr0081334,FBgn0032848,27
2L,20096476,20097149,673,610,2,FBtr0081338,FBgn0032849,10
2L,20100947,20102513,1566,925,5,FBtr0081336,FBgn0032850,7
2L,20103449,20104063,614,614,1,FBtr0089388,FBgn0032851,13
2L,20133846,20134901,1055,945,3,FBtr0081378,FBgn0032853,9
2L,20256157,20256930,773,773,1,FBtr0081376,FBgn0259998,18
2L,20263898,20264299,401,401,1,FBtr0081375,FBgn0260000,13
2L,20294886,20295173,287,287,1,FBtr0081351,FBgn0040996,1
2L,20311820,20347166,35346,3043,17,FBtr0081352,FBgn0003475,54
2L,20348684,20349924,1240,1168,2,FBtr0081374,FBgn0011638,13
2L,20355410,20364487,9077,2054,7,FBtr0081356,FBgn0015803,67
2L,20372476,20373967,1491,1438,2,FBtr0081372,FBgn0026756,25
2L,20377386,20381932,4546,1677,6,FBtr0081371,FBgn0032856,52
2L,20386320,20387531,1211,1211,1,FBtr0081369,FBgn0032857,25
2L,20415271,20416704,1433,1375,2,FBtr0081367,FBgn0032858,30
2L,20417594,20422493,4899,895,8,FBtr0081358,FBgn0032859,7
2L,20423188,20424599,1411,348,3,FBtr0307019,FBgn0032860,3
2L,20432501,20441854,9353,575,4,FBtr0273378,FBgn0263355,13
2L,20448066,20449528,1462,1259,4,FBtr0081365,FBgn0051683,4
2L,20450301,20451411,1110,1051,2,FBtr0302224,FBgn0051687,15
2L,20457183,20458645,1462,1259,4,FBtr0081364,FBgn0042175,0
2L,20459418,20461569,2151,2031,3,FBtr0081362,FBgn0032863,19
2L,20461946,20463370,1424,1424,1,FBtr0081363,FBgn0032864,30
2L,20472982,20473303,321,268,2,FBtr0306287,FBgn0262878,4
2L,20495106,20495445,339,280,2,FBtr0100062,FBgn0054007,6
2L,20531177,20531622,445,388,2,FBtr0339236,FBgn0265256,9
2L,20603627,20604100,473,473,1,FBtr0081407,FBgn0051677,5
2L,20614681,20615379,698,698,1,FBtr0081381,FBgn0032867,15
2L,20634565,20635112,547,475,2,FBtr0081382,FBgn0032868,6
2L,20640150,20640661,511,439,2,FBtr0081383,FBgn0051680,2
2L,20640940,20641512,572,505,2,FBtr0301938,FBgn0261058,8
2L,20642460,20643104,644,644,1,FBtr0081406,FBgn0032869,7
2L,20643648,20645330,1682,1618,2,FBtr0081404,FBgn0016054,45
2L,20646095,20646859,764,764,1,FBtr0081384,FBgn0032870,8
2L,20649037,20649936,899,899,1,FBtr0081386,FBgn0042133,8
2L,20650251,20650722,471,394,2,FBtr0081387,FBgn0032871,8
2L,20651293,20655784,4491,3950,10,FBtr0081403,FBgn0261787,41
2L,20656510,20659075,2565,2011,8,FBtr0081388,FBgn0032873,22
2L,20659616,20675689,16073,4245,6,FBtr0290059,FBgn0051678,95
2L,20676305,20678768,2463,2154,6,FBtr0081390,FBgn0086657,23
2L,20679123,20681492,2369,2369,1,FBtr0081399,FBgn0032876,21
2L,20682449,20683270,821,821,1,FBtr0081391,FBgn0032877,7
2L,20686813,20713469,26656,3229,5,FBtr0081397,FBgn0014859,135
2L,20725000,20726456,1456,1341,3,FBtr0081396,FBgn0032878,22
2L,20727622,20730252,2630,2015,7,FBtr0081395,FBgn0032879,35
2L,20731003,20734063,3060,1972,5,FBtr0081393,FBgn0032880,4
2L,20735373,20738899,3526,2647,5,FBtr0081392,FBgn0262743,22
2L,20751005,20752196,1191,1117,2,FBtr0081460,FBgn0032881,19
2L,20752612,20754555,1943,1721,4,FBtr0081409,FBgn0032882,21
2L,20754675,20757782,3107,2820,6,FBtr0081459,FBgn0032883,38
2L,20760438,20760894,456,388,2,FBtr0305960,FBgn0011202,9
2L,20760526,20766587,6061,3269,4,FBtr0081410,FBgn0011202,42
2L,20771108,20782277,11169,1279,2,FBtr0081412,FBgn0000251,61
2L,20787783,20788535,752,399,3,FBtr0081414,FBgn0032884,15
2L,20789250,20796758,7508,1835,10,FBtr0089945,FBgn0250785,15
2L,20810313,20813709,3396,537,3,FBtr0081416,FBgn0032886,8
2L,20814417,20816176,1759,1450,5,FBtr0081455,FBgn0053322,16
2L,20816552,20817262,710,588,3,FBtr0081454,FBgn0067311,4
2L,20817819,20818532,713,588,3,FBtr0081453,FBgn0067312,20
2L,20820154,20820867,713,591,3,FBtr0081452,FBgn0032888,7
2L,20825421,20827612,2191,1087,5,FBtr0081420,FBgn0032889,9
2L,20829670,20830976,1306,974,4,FBtr0081422,FBgn0051673,21
2L,20831478,20832780,1302,977,4,FBtr0081423,FBgn0051674,18
2L,20832861,20835607,2746,2319,6,FBtr0290042,FBgn0032891,51
2L,20836692,20837974,1282,1112,4,FBtr0081450,FBgn0028986,10
2L,20840978,20848780,7802,474,3,FBtr0081424,FBgn0051676,10
2L,20849386,20850213,827,827,1,FBtr0081425,FBgn0032894,6
2L,20852749,20856632,3883,495,3,FBtr0081426,FBgn0032895,6
2L,20857154,20857891,737,737,1,FBtr0081449,FBgn0032896,25
2L,20859273,20860887,1614,441,3,FBtr0081427,FBgn0032897,7
2L,20865293,20867141,1848,438,3,FBtr0081428,FBgn0032899,6
2L,20868146,20869334,1188,441,3,FBtr0081429,FBgn0051675,7
2L,20870134,20871052,918,435,3,FBtr0081430,FBgn0032900,5
2L,20873752,20903166,29414,1695,9,FBtr0081440,FBgn0032901,11
2L,20903436,20903480,44,44,1,FBtr0330258,FBgn0263996,0
2L,20919242,20922752,3510,2652,6,FBtr0081439,FBgn0266369,38
2L,20925099,20926046,947,734,4,FBtr0081438,FBgn0032906,13
2L,20926451,20927799,1348,1160,4,FBtr0089944,FBgn0032907,24
2L,20929587,20933977,4390,3869,7,FBtr0306031,FBgn0032908,47
2L,20967389,21051859,84470,442,2,FBtr0290305,FBgn0250867,16
2L,21053134,21057202,4068,2391,6,FBtr0081461,FBgn0010395,36
2L,21058244,21069564,11320,1189,8,FBtr0081507,FBgn0032910,20
2L,21075702,21080749,5047,2046,9,FBtr0329987,FBgn0032911,33
2L,21081130,21082494,1364,1242,3,FBtr0346727,FBgn0053511,21
2L,21082892,21084287,1395,1275,3,FBtr0300360,FBgn0053510,9
2L,21084711,21086374,1663,1164,3,FBtr0091449,FBgn0053509,24
2L,21086903,21088730,1827,1373,7,FBtr0091448,FBgn0053508,15
2L,21089567,21090832,1265,1265,1,FBtr0081464,FBgn0032913,23
2L,21091367,21094792,3425,318,3,FBtr0300444,FBgn0032914,6
2L,21095056,21102261,7205,3206,7,FBtr0114615,FBgn0284251,42
2L,21097189,21098724,1535,229,2,FBtr0110944,FBgn0083972,5
2L,21102883,21103923,1040,1040,1,FBtr0081465,FBgn0032916,17
2L,21104635,21104760,125,125,1,FBtr0452122,FBgn0284223,7
2L,21114682,21132523,17841,3854,19,FBtr0081466,FBgn0040297,56
2L,21134704,21141788,7084,3559,11,FBtr0306017,FBgn0023388,52
2L,21143306,21145075,1769,1518,3,FBtr0081468,FBgn0032919,26
2L,21145302,21148362,3060,2940,3,FBtr0081502,FBgn0086251,39
2L,21154479,21156043,1564,1105,5,FBtr0081501,FBgn0024371,13
2L,21156971,21157456,485,485,1,FBtr0081469,FBgn0032921,1
2L,21157520,21158563,1043,927,3,FBtr0081500,FBgn0032922,7
2L,21159009,21160564,1555,1480,2,FBtr0081470,FBgn0032923,32
2L,21161015,21163002,1987,1872,3,FBtr0081499,FBgn0032924,14
2L,21163679,21166035,2356,2296,2,FBtr0081472,FBgn0032925,17
2L,21166103,21166552,449,449,1,FBtr0306975,FBgn0263051,4
2L,21166682,21168214,1532,1477,2,FBtr0306974,FBgn0263050,32
2L,21168772,21172645,3873,2357,4,FBtr0081473,FBgn0010100,30
2L,21173288,21174129,841,784,2,FBtr0300424,FBgn0051627,6
2L,21174877,21177660,2783,2040,9,FBtr0301342,FBgn0000239,15
2L,21180031,21182418,2387,2326,2,FBtr0081475,FBgn0032929,26
2L,21183176,21195129,11953,3699,6,FBtr0081493,FBgn0011829,25
2L,21199404,21199937,533,533,1,FBtr0081491,FBgn0051624,9
2L,21201719,21202252,533,533,1,FBtr0081490,FBgn0051988,4
2L,21206650,21211651,5001,2995,11,FBtr0110895,FBgn0026255,35
2L,21206938,21210695,3757,2103,9,FBtr0081476,FBgn0026255,21
2L,21213069,21220297,7228,1409,4,FBtr0081487,FBgn0032935,22
2L,21216311,21218422,2111,2111,1,FBtr0081488,FBgn0032934,33
2L,21221552,21231105,9553,7981,8,FBtr0331677,FBgn0026577,110
2L,21232648,21233637,989,853,2,FBtr0081485,FBgn0051626,20
2L,21253670,21256064,2394,2100,3,FBtr0081478,FBgn0261239,41
2L,21261235,21262260,1025,833,4,FBtr0081482,FBgn0021856,21
2L,21273596,21281511,7915,3108,9,FBtr0081483,FBgn0032938,33
2L,21286295,21308787,22492,3346,11,FBtr0081524,FBgn0032940,33
2L,21290734,21297683,6949,1112,4,FBtr0081508,FBgn0264556,8
2L,21311875,21319054,7179,1139,4,FBtr0081512,FBgn0000370,17
2L,21314897,21314974,77,77,1,FBtr0452129,FBgn0284230,0
2L,21339111,21340344,1233,1168,2,FBtr0081514,FBgn0023091,19
2L,21355532,21356802,1270,702,3,FBtr0273404,FBgn0032943,9
2L,21361379,21367196,5817,4444,5,FBtr0081516,FBgn0023090,77
2L,21367911,21369706,1795,1104,3,FBtr0081522,FBgn0041245,20
2L,21371351,21377234,5883,2736,3,FBtr0081517,FBgn0032945,23
2L,21382204,21390152,7948,926,7,FBtr0081518,FBgn0032946,5
2L,21417112,21417879,767,767,1,FBtr0091805,FBgn0053801,0
2L,21418292,21418660,368,368,1,FBtr0091914,FBgn0053910,0
2L,21419579,21419887,308,308,1,FBtr0091913,FBgn0053909,0
2L,21420186,21420593,407,407,1,FBtr0091807,FBgn0053803,0
2L,21422014,21422781,767,767,1,FBtr0085892,FBgn0051617,2
2L,21423194,21423562,368,368,1,FBtr0085927,FBgn0061209,0
2L,21423789,21424160,371,371,1,FBtr0085893,FBgn0051618,0
2L,21424641,21424949,308,308,1,FBtr0085926,FBgn0051611,0
2L,21425250,21425657,407,407,1,FBtr0085894,FBgn0051613,0
2L,21427075,21427842,767,767,1,FBtr0091808,FBgn0053804,0
2L,21428255,21428623,368,368,1,FBtr0091912,FBgn0053908,0
2L,21429703,21430011,308,308,1,FBtr0091911,FBgn0053907,0
2L,21430312,21430719,407,407,1,FBtr0091810,FBgn0053806,0
2L,21432122,21432889,767,767,1,FBtr0091811,FBgn0053807,2
2L,21433302,21433670,368,368,1,FBtr0091910,FBgn0053906,0
2L,21433897,21434268,371,371,1,FBtr0091812,FBgn0053808,0
2L,21434751,21435059,308,308,1,FBtr0091909,FBgn0053905,0
2L,21435356,21435763,407,407,1,FBtr0091813,FBgn0053809,0
2L,21437170,21437937,767,767,1,FBtr0091814,FBgn0053810,0
2L,21438350,21438718,368,368,1,FBtr0091908,FBgn0053904,0
2L,21439637,21439945,308,308,1,FBtr0091907,FBgn0053903,0
2L,21440244,21440651,407,407,1,FBtr0091816,FBgn0053812,0
2L,21451211,21451978,767,767,1,FBtr0091817,FBgn0053813,0
2L,21452391,21452759,368,368,1,FBtr0091906,FBgn0053902,0
2L,21452986,21453357,371,371,1,FBtr0091818,FBgn0053814,0
2L,21453838,21454146,308,308,1,FBtr0091905,FBgn0053901,0
2L,21454445,21454852,407,407,1,FBtr0091819,FBgn0053815,0
2L,21456272,21457039,767,767,1,FBtr0091820,FBgn0053816,0
2L,21457452,21457820,368,368,1,FBtr0091904,FBgn0053900,0
2L,21458047,21458418,371,371,1,FBtr0091821,FBgn0053817,0
2L,21458901,21459209,308,308,1,FBtr0091903,FBgn0053899,2
2L,21459504,21459911,407,407,1,FBtr0091822,FBgn0053818,0
2L,21461332,21462099,767,767,1,FBtr0091823,FBgn0053819,0
2L,21462512,21462880,368,368,1,FBtr0091902,FBgn0053898,0
2L,21463107,21463478,371,371,1,FBtr0091824,FBgn0053820,0
2L,21463961,21464269,308,308,1,FBtr0091901,FBgn0053897,2
2L,21464564,21464971,407,407,1,FBtr0091825,FBgn0053821,0
2L,21466375,21467142,767,767,1,FBtr0091826,FBgn0053822,0
2L,21467555,21467923,368,368,1,FBtr0091900,FBgn0053896,0
2L,21468150,21468521,371,371,1,FBtr0091827,FBgn0053823,0
2L,21469004,21469312,308,308,1,FBtr0091899,FBgn0053895,3
2L,21469607,21470014,407,407,1,FBtr0091828,FBgn0053824,0
2L,21471418,21472185,767,767,1,FBtr0091829,FBgn0053825,0
2L,21472598,21472966,368,368,1,FBtr0091898,FBgn0053894,0
2L,21473193,21473564,371,371,1,FBtr0091830,FBgn0053826,0
2L,21474047,21474355,308,308,1,FBtr0091897,FBgn0053893,5
2L,21474650,21475057,407,407,1,FBtr0091831,FBgn0053827,2
2L,21476461,21477228,767,767,1,FBtr0091832,FBgn0053828,0
2L,21477641,21478009,368,368,1,FBtr0091896,FBgn0053892,0
2L,21478236,21478607,371,371,1,FBtr0091833,FBgn0053829,0
2L,21479090,21479398,308,308,1,FBtr0091895,FBgn0053891,3
2L,21479693,21480100,407,407,1,FBtr0091834,FBgn0053830,2
2L,21481504,21482271,767,767,1,FBtr0091835,FBgn0053831,0
2L,21482684,21483052,368,368,1,FBtr0091894,FBgn0053890,0
2L,21483279,21483650,371,371,1,FBtr0091836,FBgn0053832,0
2L,21484133,21484441,308,308,1,FBtr0091893,FBgn0053889,0
2L,21484738,21485145,407,407,1,FBtr0091837,FBgn0053833,0
2L,21486655,21487422,767,767,1,FBtr0091838,FBgn0053834,0
2L,21487835,21488203,368,368,1,FBtr0091892,FBgn0053888,0
2L,21488430,21488801,371,371,1,FBtr0091839,FBgn0053835,0
2L,21489282,21489590,308,308,1,FBtr0091891,FBgn0053887,0
2L,21489887,21490294,407,407,1,FBtr0091840,FBgn0053836,0
2L,21491700,21492467,767,767,1,FBtr0091841,FBgn0053837,1
2L,21492880,21493248,368,368,1,FBtr0091890,FBgn0053886,0
2L,21493475,21493846,371,371,1,FBtr0091842,FBgn0053838,0
2L,21494327,21494635,308,308,1,FBtr0091889,FBgn0053885,0
2L,21494932,21495339,407,407,1,FBtr0091843,FBgn0053839,0
2L,21496745,21497512,767,767,1,FBtr0091844,FBgn0053840,0
2L,21497925,21498293,368,368,1,FBtr0091888,FBgn0053884,0
2L,21498520,21498891,371,371,1,FBtr0091845,FBgn0053841,0
2L,21499372,21499680,308,308,1,FBtr0091887,FBgn0053883,0
2L,21499977,21500384,407,407,1,FBtr0091846,FBgn0053842,0
2L,21501792,21502559,767,767,1,FBtr0091847,FBgn0053843,0
2L,21502978,21503346,368,368,1,FBtr0091886,FBgn0053882,0
2L,21503573,21503944,371,371,1,FBtr0091848,FBgn0053844,0
2L,21504425,21504733,308,308,1,FBtr0091885,FBgn0053881,0
2L,21505030,21505437,407,407,1,FBtr0091849,FBgn0053845,0
2L,21506843,21507610,767,767,1,FBtr0091850,FBgn0053846,0
2L,21508023,21508391,368,368,1,FBtr0091884,FBgn0053880,0
2L,21508618,21508989,371,371,1,FBtr0091851,FBgn0053847,0
2L,21509470,21509778,308,308,1,FBtr0091883,FBgn0053879,0
2L,21510075,21510482,407,407,1,FBtr0091852,FBgn0053848,0
2L,21511887,21512654,767,767,1,FBtr0091853,FBgn0053849,0
2L,21513067,21513435,368,368,1,FBtr0091882,FBgn0053878,0
2L,21513662,21514033,371,371,1,FBtr0091854,FBgn0053850,0
2L,21514514,21514822,308,308,1,FBtr0091881,FBgn0053877,0
2L,21515119,21515526,407,407,1,FBtr0091855,FBgn0053851,0
2L,21516932,21517699,767,767,1,FBtr0091856,FBgn0053852,0
2L,21518112,21518480,368,368,1,FBtr0091880,FBgn0053876,0
2L,21518707,21519078,371,371,1,FBtr0091857,FBgn0053853,2
2L,21519559,21519867,308,308,1,FBtr0091879,FBgn0053875,0
2L,21520166,21520573,407,407,1,FBtr0091858,FBgn0053854,0
2L,21521775,21522542,767,767,1,FBtr0091859,FBgn0053855,2
2L,21522955,21523323,368,368,1,FBtr0091878,FBgn0053874,0
2L,21523550,21523921,371,371,1,FBtr0091860,FBgn0053856,1
2L,21524402,21524710,308,308,1,FBtr0091877,FBgn0053873,0
2L,21525009,21525416,407,407,1,FBtr0091861,FBgn0053857,0
2L,21526618,21527385,767,767,1,FBtr0091862,FBgn0053858,3
2L,21527798,21528166,368,368,1,FBtr0091876,FBgn0053872,0
2L,21528393,21528764,371,371,1,FBtr0091863,FBgn0053859,4
2L,21529245,21529553,308,308,1,FBtr0091875,FBgn0053871,0
2L,21529852,21530259,407,407,1,FBtr0091864,FBgn0053860,0
2L,21531461,21532228,767,767,1,FBtr0091865,FBgn0053861,1
2L,21532641,21533009,368,368,1,FBtr0091874,FBgn0053870,0
2L,21533236,21533607,371,371,1,FBtr0091866,FBgn0053862,0
2L,21534088,21534396,308,308,1,FBtr0091873,FBgn0053869,0
2L,21534693,21535100,407,407,1,FBtr0091867,FBgn0053863,0
2L,21536505,21537272,767,767,1,FBtr0091868,FBgn0053864,0
2L,21537685,21538053,368,368,1,FBtr0091872,FBgn0053868,0
2L,21538280,21538651,371,371,1,FBtr0091869,FBgn0053865,0
2L,21541210,21541617,407,407,1,FBtr0091870,FBgn0053866,0
2L,21573495,21576580,3085,950,4,FBtr0085896,FBgn0032949,12
2L,21578411,21589355,10944,2513,7,FBtr0301173,FBgn0016919,19
2L,21614981,21623386,8405,1546,8,FBtr0085921,FBgn0032955,15
2L,21617277,21618624,1347,716,4,FBtr0100511,FBgn0032955,5
2L,21627603,21629692,2089,546,3,FBtr0085919,FBgn0022893,25
2L,21633627,21646822,13195,3484,17,FBtr0085897,FBgn0023416,25
2L,21659154,21662817,3663,2251,8,FBtr0085899,FBgn0032956,17
2L,21665465,21673050,7585,3290,10,FBtr0085914,FBgn0032957,58
2L,21678314,21682041,3727,2527,5,FBtr0085911,FBgn0000559,37
2L,21688499,21728170,39671,4042,17,FBtr0085901,FBgn0051619,71
2L,21741586,21757242,15656,1221,9,FBtr0085910,FBgn0086779,8
2L,21758212,21760620,2408,1058,4,FBtr0085903,FBgn0032961,15
2L,21762578,21775440,12862,2958,3,FBtr0085908,FBgn0051612,31
2L,21782121,21784013,1892,1892,1,FBtr0085909,FBgn0032964,7
2L,21829806,21836179,6373,2860,2,FBtr0085906,FBgn0003866,37
2L,21896873,21898261,1388,1388,1,FBtr0085950,FBgn0032965,13
2L,21903150,21903713,563,563,1,FBtr0085928,FBgn0032966,10
2L,21906353,21908203,1850,1850,1,FBtr0085929,FBgn0032967,14
2L,21914443,21915302,859,695,4,FBtr0085949,FBgn0283728,13
2L,21916405,21917298,893,893,1,FBtr0085930,FBgn0032968,7
2L,21979413,21992879,13466,2179,2,FBtr0347504,FBgn0032969,33
2L,22015233,22017296,2063,2063,1,FBtr0085931,FBgn0051693,16
2L,22020035,22023925,3890,3069,3,FBtr0089377,FBgn0028979,58
2L,22038032,22039339,1307,1179,3,FBtr0332199,FBgn0084001,15
2L,22040793,22043687,2894,2171,7,FBtr0307507,FBgn0051601,35
2L,22053978,22054112,134,134,1,FBtr0112364,FBgn0085202,1
2L,22064696,22065193,497,497,1,FBtr0301799,FBgn0260996,9
2L,22071301,22072672,1371,1321,2,FBtr0085934,FBgn0051702,17
2L,22079688,22080716,1028,1028,1,FBtr0085935,FBgn0032971,12
2L,22102858,22104223,1365,1315,2,FBtr0085946,FBgn0051703,10
2L,22104928,22105401,473,354,3,FBtr0306060,FBgn0040519,2
2L,22106954,22107244,290,290,1,FBtr0085943,FBgn0032972,6
2L,22109116,22110346,1230,1168,2,FBtr0299905,FBgn0032973,16
2L,22121872,22124936,3064,2305,5,FBtr0331656,FBgn0032974,25
2L,22128524,22129723,1199,1199,1,FBtr0085941,FBgn0025674,11
2L,22140824,22158741,17917,5123,7,FBtr0303271,FBgn0261802,52
2L,22151826,22152563,737,737,1,FBtr0110947,FBgn0083973,10
2L,22166555,22168535,1980,1677,6,FBtr0085964,FBgn0032979,11
2L,22175450,22183920,8470,1272,3,FBtr0299879,FBgn0032981,7
2L,22189587,22197861,8274,836,4,FBtr0334170,FBgn0259683,10
2L,22239932,22240860,928,877,2,FBtr0299875,FBgn0032986,7
2L,22247229,22247705,476,476,1,FBtr0085961,FBgn0032987,4
2L,22250099,22258176,8077,1827,6,FBtr0085955,FBgn0032988,12
2L,22325827,22368440,42613,3875,7,FBtr0085957,FBgn0039972,96
2L,22534872,22536539,1667,893,4,FBtr0111129,FBgn0064225,2
2L,22538312,22540485,2173,2119,2,FBtr0302386,FBgn0040009,19
2L,22550559,22551104,545,545,1,FBtr0332630,FBgn0040010,1
2L,22579841,22585578,5737,2688,3,FBtr0111252,FBgn0040011,18
2L,22643140,22756124,112984,2058,9,FBtr0111230,FBgn0058006,18
2L,22797655,22798218,563,511,2,FBtr0111232,FBgn0058439,3
2L,22844571,22849097,4526,403,2,FBtr0111244,FBgn0041004,2
2L,22924896,22940443,15547,2511,12,FBtr0111125,FBgn0002566,16
2L,22982198,22991940,9742,1365,6,FBtr0111126,FBgn0000384,0
2L,22999676,23016070,16394,6851,7,FBtr0111127,FBgn0250907,38
2L,23066992,23068316,1324,1206,3,FBtr0111239,FBgn0086683,18
2L,23161961,23174134,12173,1043,4,FBtr0113704,FBgn0039958,0
2L,23311778,23312344,566,505,2,FBtr0113777,FBgn0063368,0
2L,23312542,23313380,838,614,4,FBtr0113781,FBgn0267976,0